Rk,Player,Nation,Pos,Squad,Age,Born,90s,Tkl,TklW,Def 3rd,Mid 3rd,Att 3rd,Tkl.1,Attd,Tkl%,Lostd,Blocks,Sh,Pass,Int,Tkl+Int,Clr,Err,Matches
1,Aaron Cresswell,engENG,DF,West Ham,35-139,1989.0,6.5,8,4,3,4,1,6,8,75.0,2,7,4,3,6,14,30,0,Matches
2,Aaron Ramsdale,engENG,GK,Southampton,26-354,1998.0,26.0,0,0,0,0,0,0,2,0.0,2,0,0,0,2,2,8,2,Matches
3,Aaron Wan-Bissaka,engENG,DF,West Ham,27-158,1997.0,31.0,61,43,29,27,5,19,26,73.1,7,31,9,22,59,120,115,0,Matches
4,Abdoulaye Doucouré,mlMLI,MF,Everton,32-122,1993.0,26.9,45,27,20,18,7,13,39,33.3,26,30,6,24,9,54,19,1,Matches
5,Abdukodir Khusanov,uzUZB,DF,Manchester City,21-063,2004.0,5.6,5,4,4,1,0,2,3,66.7,1,5,4,1,3,8,29,1,Matches
6,Abdul Fatawu Issahaku,ghGHA,FW,Leicester City,21-056,2004.0,6.4,21,15,13,2,6,11,19,57.9,8,7,0,7,4,25,12,0,Matches
7,Adam Armstrong,engENG,"FW,MF",Southampton,28-082,1997.0,13.9,12,3,2,7,3,3,14,21.4,11,6,1,5,3,15,8,0,Matches
8,Adam Lallana,engENG,MF,Southampton,36-358,1988.0,4.0,8,5,4,4,0,2,12,16.7,10,4,1,3,5,13,5,0,Matches
9,Adam Smith,engENG,DF,Bournemouth,34-004,1991.0,15.7,21,10,10,5,6,12,25,48.0,13,12,5,7,14,35,47,1,Matches
10,Adam Webster,engENG,DF,Brighton,30-119,1995.0,6.9,8,5,4,3,1,5,11,45.5,6,12,9,3,14,22,28,1,Matches
11,Adam Wharton,engENG,MF,Crystal Palace,20-335,2004.0,14.0,34,14,14,16,4,17,43,39.5,26,10,2,8,18,52,25,0,Matches
12,Adama Traoré,esESP,"FW,MF",Fulham,29-098,1996.0,17.4,17,12,8,4,5,5,13,38.5,8,7,0,7,1,18,6,3,Matches
13,Albert Grønbaek,dkDEN,"FW,MF",Southampton,23-345,2001.0,1.6,4,1,1,1,2,3,10,30.0,7,1,1,0,0,4,1,0,Matches
14,Alejandro Garnacho,arARG,"MF,FW",Manchester Utd,20-306,2004.0,22.8,28,18,10,6,12,11,34,32.4,23,19,0,19,13,41,10,2,Matches
15,Alex Iwobi,ngNGA,"FW,MF",Fulham,29-000,1996.0,30.2,37,21,13,19,5,17,28,60.7,11,25,1,24,11,48,28,0,Matches
16,Alex McCarthy,engENG,GK,Southampton,35-151,1989.0,5.0,0,0,0,0,0,0,0,,0,0,0,0,0,0,1,4,Matches
17,Alex Palmer,engENG,GK,Ipswich Town,28-266,1996.0,10.0,0,0,0,0,0,0,0,,0,0,0,0,0,0,11,0,Matches
18,Alex Scott,engENG,MF,Bournemouth,21-255,2003.0,7.6,25,12,10,8,7,17,38,44.7,21,15,3,12,10,35,13,0,Matches
19,Alexander Isak,seSWE,FW,Newcastle Utd,25-224,1999.0,27.6,12,5,2,3,7,5,12,41.7,7,18,2,16,3,15,17,1,Matches
20,Alexis Mac Allister,arARG,MF,Liverpool,26-130,1998.0,28.4,95,58,28,51,16,55,101,54.5,46,60,6,54,22,117,29,1,Matches
21,Alfie Dorrington,engENG,DF,Tottenham,20-013,2005.0,0.2,0,0,0,0,0,0,0,,0,0,0,0,0,0,0,0,Matches
22,Alfie Pond,engENG,DF,Wolves,21-063,2004.0,0.0,0,0,0,0,0,0,0,,0,0,0,0,0,0,0,0,Matches
23,Ali Al Hamadi,iqIRQ,FW,Ipswich Town,23-063,2002.0,1.5,1,0,0,0,1,0,2,0.0,2,0,0,0,0,1,2,0,Matches
24,Alisson,brBRA,GK,Liverpool,32-213,1992.0,23.9,1,0,1,0,0,0,1,0.0,1,0,0,0,0,1,13,1,Matches
25,Alphonse Areola,frFRA,GK,West Ham,32-065,1993.0,22.1,2,2,2,0,0,2,3,66.7,1,0,0,0,0,2,15,2,Matches
26,Altay Bayındır,trTUR,GK,Manchester Utd,27-019,1998.0,1.0,0,0,0,0,0,0,1,0.0,1,0,0,0,0,0,3,1,Matches
27,Amad Diallo,ciCIV,"FW,MF",Manchester Utd,22-296,2002.0,17.7,33,26,6,19,8,15,26,57.7,11,10,0,10,11,44,16,0,Matches
28,Amadou Onana,beBEL,MF,Aston Villa,23-260,2001.0,15.0,46,24,21,21,4,14,24,58.3,10,14,6,8,24,70,36,3,Matches
29,Andreas Pereira,brBRA,MF,Fulham,29-122,1996.0,20.9,22,12,7,11,4,10,40,25.0,30,16,2,14,8,30,15,2,Matches
30,Andrew Robertson,sctSCO,DF,Liverpool,31-053,1994.0,25.6,38,22,24,10,4,30,47,63.8,17,9,4,5,20,58,51,2,Matches
31,André,brBRA,MF,Wolves,23-291,2001.0,25.0,80,48,36,37,7,32,57,56.1,25,41,8,33,32,112,27,1,Matches
32,André Onana,cmCMR,GK,Manchester Utd,29-031,1996.0,33.0,1,1,1,0,0,1,3,33.3,2,0,0,0,0,1,11,4,Matches
33,Andrés García,esESP,"DF,MF",Aston Villa,22-085,2003.0,3.5,9,5,5,3,1,4,8,50.0,4,2,0,2,2,11,10,2,Matches
34,Andy Irving,sctSCO,MF,West Ham,24-355,2000.0,1.8,7,4,3,3,1,1,5,20.0,4,5,1,4,1,8,5,0,Matches
35,Anthony Elanga,seSWE,"FW,MF",Nott'ham Forest,23-006,2002.0,23.8,17,12,7,8,2,4,16,25.0,12,11,1,10,5,22,25,0,Matches
36,Anthony Gordon,engENG,FW,Newcastle Utd,24-068,2001.0,24.4,31,17,9,18,4,12,34,35.3,22,24,2,22,6,37,9,2,Matches
37,Antoine Semenyo,ghGHA,FW,Bournemouth,25-116,2000.0,32.3,53,34,16,24,13,16,42,38.1,26,59,8,51,10,63,35,1,Matches
38,Antonee Robinson,usUSA,DF,Fulham,27-268,1997.0,32.2,84,56,51,27,6,43,86,50.0,43,36,6,30,56,140,119,2,Matches
39,Antony,brBRA,"DF,MF",Manchester Utd,25-068,2000.0,1.6,6,3,4,2,0,2,5,40.0,3,2,0,2,2,8,0,0,Matches
40,Antonín Kinský,czCZE,GK,Tottenham,22-051,2003.0,4.0,3,1,3,0,0,1,1,100.0,0,0,0,0,0,3,5,1,Matches
41,Archie Gray,engENG,"DF,MF",Tottenham,19-052,2006.0,15.5,12,6,3,6,3,6,16,37.5,10,19,10,9,12,24,39,2,Matches
42,Arijanet Muric,xkKVX,GK,Ipswich Town,26-177,1998.0,18.0,0,0,0,0,0,0,2,0.0,2,0,0,0,0,0,10,5,Matches
43,Armando Broja,alALB,FW,Everton,23-235,2001.0,3.7,3,1,1,1,1,0,0,,0,3,0,3,1,4,4,0,Matches
44,Armel Bella Kotchap,deGER,DF,Southampton,23-143,2001.0,3.7,7,5,5,2,0,3,6,50.0,3,2,2,0,5,12,21,1,Matches
45,Asher Agbinone,engENG,MF,Crystal Palace,19-217,2005.0,0.1,2,1,0,2,0,0,0,,0,0,0,0,0,2,0,0,Matches
46,Ashley Young,engENG,"DF,FW",Everton,39-298,1985.0,17.9,50,28,22,21,7,31,50,62.0,19,10,3,7,23,73,58,1,Matches
47,Axel Disasi,frFRA,DF,Chelsea,27-053,1998.0,4.0,7,4,5,1,1,6,11,54.5,5,4,1,3,2,9,11,1,Matches
48,Axel Disasi,frFRA,DF,Aston Villa,27-053,1998.0,5.4,8,5,7,1,0,3,7,42.9,4,4,1,3,5,13,18,0,Matches
49,Axel Tuanzebe,cdCOD,DF,Ipswich Town,27-170,1997.0,16.1,29,17,20,3,6,16,24,66.7,8,18,9,9,21,50,53,1,Matches
50,Ayden Heaven,engENG,DF,Manchester Utd,18-223,2006.0,1.1,3,3,1,2,0,2,2,100.0,0,2,2,0,1,4,6,0,Matches
51,Bart Verbruggen,nlNED,GK,Brighton,22-258,2002.0,32.0,0,0,0,0,0,0,3,0.0,3,1,0,1,0,0,26,5,Matches
52,Ben Brereton,clCHI,FW,Southampton,26-015,1999.0,5.0,3,2,0,2,1,1,9,11.1,8,2,1,1,0,3,4,0,Matches
53,Ben Chilwell,engENG,DF,Crystal Palace,28-133,1996.0,1.5,4,4,2,2,0,0,3,0.0,3,3,1,2,4,8,11,0,Matches
54,Ben Davies,wlsWAL,DF,Tottenham,32-009,1993.0,11.5,13,9,6,7,0,6,13,46.2,7,23,15,8,11,24,62,1,Matches
55,Ben Godfrey,engENG,DF,Ipswich Town,27-108,1998.0,1.8,1,0,1,0,0,1,1,100.0,0,1,1,0,2,3,3,0,Matches
56,Ben Johnson,engENG,"DF,FW",Ipswich Town,25-099,2000.0,15.0,38,22,23,12,3,20,41,48.8,21,22,5,17,13,51,54,1,Matches
57,Ben Mee,engENG,DF,Brentford,35-224,1989.0,2.0,2,2,0,2,0,1,1,100.0,0,3,3,0,4,6,7,0,Matches
58,Ben White,engENG,DF,Arsenal,27-207,1997.0,9.5,12,8,9,1,2,10,24,41.7,14,9,7,2,12,24,29,0,Matches
59,Ben Winterburn,engENG,"FW,MF",Bournemouth,20-241,2004.0,0.3,0,0,0,0,0,0,1,0.0,1,0,0,0,2,2,0,0,Matches
60,Benoît Badiashile,frFRA,DF,Chelsea,24-038,2001.0,3.7,9,6,5,4,0,4,5,80.0,1,2,2,0,6,15,12,2,Matches
61,Bernardo Silva,ptPOR,"MF,FW",Manchester City,30-266,1994.0,26.7,52,34,15,28,9,24,52,46.2,28,33,7,26,20,72,28,3,Matches
62,Bernd Leno,deGER,GK,Fulham,33-060,1992.0,34.0,2,2,2,0,0,2,2,100.0,0,1,0,1,0,2,8,4,Matches
63,Beto,gwGNB,FW,Everton,27-092,1998.0,13.2,13,6,2,7,4,5,8,62.5,3,7,1,6,3,16,18,1,Matches
64,Bilal El Khannouss,maMAR,MF,Leicester City,20-358,2004.0,21.3,46,26,15,26,5,15,28,53.6,13,19,4,15,6,52,9,3,Matches
65,Billy Gilmour,sctSCO,MF,Brighton,23-326,2001.0,1.1,3,3,2,1,0,3,4,75.0,1,1,0,1,0,3,1,0,Matches
66,Bobby De Cordova-Reid,jmJAM,FW,Leicester City,32-090,1993.0,8.3,9,4,3,6,0,4,14,28.6,10,6,1,5,0,9,10,0,Matches
67,Boubacar Kamara,frFRA,MF,Aston Villa,25-161,1999.0,15.3,46,19,25,17,4,26,51,51.0,25,17,7,10,16,62,45,3,Matches
68,Boubacar Traoré,mlMLI,MF,Wolves,23-256,2001.0,0.0,2,0,0,2,0,1,1,100.0,0,0,0,0,0,2,0,0,Matches
69,Boubakary Soumaré,frFRA,MF,Leicester City,26-065,1999.0,21.7,33,18,21,11,1,18,30,60.0,12,19,7,12,24,57,30,3,Matches
70,Brajan Gruda,deGER,"FW,MF",Brighton,20-337,2004.0,5.6,14,6,6,5,3,7,14,50.0,7,8,0,8,2,16,5,1,Matches
71,Brandon Austin,engENG,GK,Tottenham,26-115,1999.0,1.0,0,0,0,0,0,0,0,,0,0,0,0,0,0,1,0,Matches
72,Brennan Johnson,wlsWAL,FW,Tottenham,23-345,2001.0,23.1,39,26,9,20,10,16,31,51.6,15,25,3,22,4,43,11,0,Matches
73,Bruno Fernandes,ptPOR,MF,Manchester Utd,30-237,1994.0,30.6,76,47,24,37,15,29,75,38.7,46,32,4,28,25,101,34,2,Matches
74,Bruno Guimarães,brBRA,MF,Newcastle Utd,27-168,1997.0,32.4,71,41,34,26,11,29,61,47.5,32,33,9,24,27,98,41,4,Matches
75,Bryan Mbeumo,cmCMR,FW,Brentford,25-269,1999.0,33.9,44,29,17,14,13,17,30,56.7,13,22,3,19,14,58,46,1,Matches
76,Bukayo Saka,engENG,"FW,MF",Arsenal,23-240,2001.0,16.2,23,13,6,10,7,10,20,50.0,10,19,0,19,2,25,7,0,Matches
77,Caleb Kporha,engENG,DF,Crystal Palace,18-292,2006.0,0.1,2,1,2,0,0,2,2,100.0,0,0,0,0,0,2,1,0,Matches
78,Caleb Okoli,itITA,DF,Leicester City,23-294,2001.0,12.5,25,14,8,15,2,11,18,61.1,7,24,14,10,15,40,79,3,Matches
79,Callum Hudson-Odoi,engENG,"FW,MF",Nott'ham Forest,24-177,2000.0,23.9,20,14,7,8,5,11,17,64.7,6,11,0,11,13,33,11,1,Matches
80,Callum Wilson,engENG,FW,Newcastle Utd,33-065,1992.0,3.0,2,2,0,1,1,0,2,0.0,2,2,0,2,1,3,1,0,Matches
81,Calvin Bassey,ngNGA,DF,Fulham,25-123,1999.0,31.2,51,32,33,18,0,20,28,71.4,8,37,17,20,18,69,102,8,Matches
82,Cameron Archer,engENG,FW,Southampton,23-286,2001.0,15.1,11,7,6,3,2,2,9,22.2,7,5,1,4,2,13,9,0,Matches
83,Cameron Burgess,auAUS,DF,Ipswich Town,29-194,1995.0,15.1,14,9,12,2,0,7,9,77.8,2,18,13,5,13,27,107,3,Matches
84,Caoimhín Kelleher,ieIRL,GK,Liverpool,26-161,1998.0,10.0,0,0,0,0,0,0,0,,0,0,0,0,0,0,1,2,Matches
85,Carlos Alcaraz,arARG,"FW,MF",Everton,22-154,2002.0,5.5,11,5,5,3,3,3,9,33.3,6,5,1,4,3,14,7,0,Matches
86,Carlos Alcaraz,arARG,MF,Southampton,22-154,2002.0,0.1,0,0,0,0,0,0,0,,0,0,0,0,1,1,0,0,Matches
87,Carlos Baleba,cmCMR,MF,Brighton,21-120,2004.0,25.7,71,41,24,32,15,44,72,61.1,28,43,10,33,40,111,37,1,Matches
88,Carlos Forbs,ptPOR,"MF,FW",Wolves,21-045,2004.0,2.7,8,5,5,2,1,4,6,66.7,2,3,0,3,1,9,2,1,Matches
89,Carlos Soler,esESP,"MF,FW",West Ham,28-121,1997.0,15.0,13,10,7,5,1,6,22,27.3,16,19,6,13,8,21,21,2,Matches
90,Carlos Vinícius,brBRA,"MF,FW",Fulham,30-039,1995.0,0.2,0,0,0,0,0,0,1,0.0,1,1,0,1,0,0,0,0,Matches
91,Casemiro,brBRA,MF,Manchester Utd,33-069,1992.0,14.8,77,46,45,23,9,41,66,62.1,25,33,10,23,12,89,48,3,Matches
92,Chadi Riad,maMAR,DF,Crystal Palace,21-320,2003.0,1.0,5,2,2,2,1,2,3,66.7,1,0,0,0,2,7,0,0,Matches
93,Charlie Taylor,engENG,DF,Southampton,31-227,1993.0,3.0,7,5,4,3,0,5,6,83.3,1,5,3,2,3,10,22,1,Matches
94,Cheick Doucouré,mlMLI,MF,Crystal Palace,25-115,2000.0,5.0,16,8,6,8,2,5,11,45.5,6,4,0,4,11,27,10,1,Matches
95,Chidozie Obi-Martin,dkDEN,FW,Manchester Utd,17-155,2007.0,0.7,2,1,0,0,2,2,2,100.0,0,0,0,0,0,2,1,0,Matches
96,Chiedozie Ogbene,ieIRL,FW,Ipswich Town,28-002,1997.0,2.6,7,3,1,2,4,2,4,50.0,2,1,0,1,1,8,3,0,Matches
97,Chiquinho,ptPOR,MF,Wolves,25-087,2000.0,0.1,0,0,0,0,0,0,0,,0,0,0,0,0,0,0,0,Matches
98,Chris Richards,usUSA,DF,Crystal Palace,25-036,2000.0,17.4,42,27,20,17,5,23,38,60.5,15,35,13,22,10,52,96,0,Matches
99,Chris Wood,nzNZL,FW,Nott'ham Forest,33-147,1991.0,28.9,4,4,1,1,2,1,8,12.5,7,11,7,4,5,9,23,1,Matches
100,Christian Eriksen,dkDEN,MF,Manchester Utd,33-078,1992.0,11.0,19,9,4,12,3,11,24,45.8,13,13,4,9,7,26,7,0,Matches
101,Christian Nørgaard,dkDEN,MF,Brentford,31-054,1994.0,27.3,73,45,32,34,7,42,68,61.8,26,48,18,30,43,116,63,1,Matches
102,Christian Walton,engENG,GK,Ipswich Town,29-175,1995.0,6.0,0,0,0,0,0,0,1,0.0,1,0,0,0,0,0,1,1,Matches
103,Christopher Nkunku,frFRA,FW,Chelsea,27-170,1997.0,10.2,12,8,3,4,5,6,8,75.0,2,9,2,7,7,19,10,0,Matches
104,Cody Gakpo,nlNED,FW,Liverpool,25-361,1999.0,18.1,26,14,5,12,9,11,23,47.8,12,19,2,17,11,37,16,1,Matches
105,Cole Palmer,engENG,MF,Chelsea,22-362,2002.0,31.5,25,16,11,7,7,8,21,38.1,13,14,1,13,8,33,17,1,Matches
106,Conor Bradley,nirNIR,DF,Liverpool,21-298,2003.0,5.9,11,8,5,4,2,8,16,50.0,8,4,0,4,3,14,21,0,Matches
107,Conor Chaplin,engENG,"MF,FW",Ipswich Town,28-076,1997.0,7.2,12,5,4,6,2,6,13,46.2,7,8,1,7,3,15,2,0,Matches
108,Conor Coady,engENG,DF,Leicester City,32-067,1993.0,15.0,12,8,6,5,1,3,5,60.0,2,26,19,7,11,23,56,2,Matches
109,Conor Townsend,engENG,DF,Ipswich Town,32-060,1993.0,3.7,11,8,9,2,0,8,11,72.7,3,8,6,2,4,15,16,0,Matches
110,Craig Dawson,engENG,DF,Wolves,34-362,1990.0,10.8,15,3,8,6,1,12,15,80.0,3,16,11,5,9,24,52,1,Matches
111,Cristian Romero,arARG,DF,Tottenham,27-006,1998.0,15.7,35,29,26,8,1,21,30,70.0,9,18,3,15,21,56,57,2,Matches
112,Crysencio Summerville,nlNED,"FW,MF",West Ham,23-185,2001.0,8.7,13,7,2,8,3,3,9,33.3,6,13,4,9,0,13,7,0,Matches
113,Curtis Jones,engENG,"MF,DF",Liverpool,24-093,2001.0,16.0,34,18,6,21,7,15,23,65.2,8,15,7,8,5,39,8,2,Matches
114,Daichi Kamada,jpJPN,MF,Crystal Palace,28-271,1996.0,14.9,43,25,17,22,4,12,37,32.4,25,19,4,15,16,59,13,0,Matches
115,Dan Burn,engENG,DF,Newcastle Utd,32-359,1992.0,33.0,33,19,20,12,1,17,32,53.1,15,32,23,9,25,58,171,3,Matches
116,Dane Scarlett,engENG,"FW,MF",Tottenham,21-040,2004.0,0.4,1,0,0,1,0,0,0,,0,0,0,0,0,1,1,0,Matches
117,Dango Ouattara,bfBFA,FW,Bournemouth,23-081,2002.0,21.5,34,25,13,11,10,17,40,42.5,23,34,9,25,11,45,50,0,Matches
118,Daniel Bentley,engENG,GK,Wolves,31-294,1993.0,1.0,0,0,0,0,0,0,0,,0,0,0,0,0,0,0,0,Matches
119,Daniel Jebbison,engENG,FW,Bournemouth,21-263,2003.0,0.8,2,1,1,1,0,2,4,50.0,2,2,1,1,1,3,1,0,Matches
120,Daniel Muñoz,coCOL,DF,Crystal Palace,28-342,1996.0,31.9,109,70,52,34,23,49,86,57.0,37,35,3,32,39,148,97,1,Matches
121,Daniel Podence,ptPOR,"MF,FW",Wolves,29-194,1995.0,0.5,0,0,0,0,0,0,1,0.0,1,0,0,0,0,0,0,0,Matches
122,Danilo,brBRA,"MF,FW",Nott'ham Forest,24-004,2001.0,3.0,6,3,5,1,0,2,4,50.0,2,2,1,1,3,9,3,0,Matches
123,Danny Ings,engENG,"FW,MF",West Ham,32-284,1992.0,3.2,4,2,2,2,0,1,3,33.3,2,5,0,5,1,5,4,0,Matches
124,Danny Ward,wlsWAL,GK,Leicester City,31-315,1993.0,1.5,0,0,0,0,0,0,0,,0,0,0,0,0,0,1,0,Matches
125,Danny Welbeck,engENG,FW,Brighton,34-158,1990.0,20.6,22,13,6,12,4,6,17,35.3,11,16,2,14,5,27,12,0,Matches
126,Dara O'Shea,ieIRL,DF,Ipswich Town,26-060,1999.0,30.7,45,28,31,11,3,20,31,64.5,11,59,47,12,31,76,200,4,Matches
127,Darwin Núñez,uyURU,FW,Liverpool,25-313,1999.0,11.3,18,15,10,3,5,5,15,33.3,10,6,0,6,3,21,12,0,Matches
128,David Brooks,wlsWAL,"FW,MF",Bournemouth,27-299,1997.0,9.1,11,4,2,6,3,1,13,7.7,12,16,2,14,5,16,7,1,Matches
129,David Raya,esESP,GK,Arsenal,29-230,1995.0,34.0,0,0,0,0,0,0,2,0.0,2,0,0,0,2,2,18,5,Matches
130,Dean Henderson,engENG,GK,Crystal Palace,28-052,1997.0,34.0,2,1,2,0,0,2,6,33.3,4,0,0,0,0,2,21,0,Matches
131,Dean Huijsen,esESP,DF,Bournemouth,20-019,2005.0,23.8,33,23,16,16,1,15,25,60.0,10,35,27,8,49,82,172,4,Matches
132,Declan Rice,engENG,MF,Arsenal,26-109,1999.0,28.6,49,22,20,23,6,16,37,43.2,21,24,11,13,24,73,44,0,Matches
133,Dejan Kulusevski,seSWE,"MF,FW",Tottenham,25-008,2000.0,25.3,43,23,16,12,15,19,49,38.8,30,27,4,23,13,56,9,1,Matches
134,Destiny Udogie,itITA,DF,Tottenham,22-156,2002.0,20.4,74,47,41,26,7,33,47,70.2,14,40,6,34,21,95,35,1,Matches
135,Diego Carlos,brBRA,DF,Aston Villa,32-049,1993.0,9.2,8,3,6,1,1,4,6,66.7,2,13,7,6,5,13,36,2,Matches
136,Diego Gómez,pyPAR,MF,Brighton,22-037,2003.0,4.9,17,10,8,7,2,9,18,50.0,9,11,0,11,7,24,9,1,Matches
137,Diogo Dalot,ptPOR,DF,Manchester Utd,26-046,1999.0,31.0,67,39,39,22,6,34,52,65.4,18,22,9,13,37,104,72,0,Matches
138,Diogo Jota,ptPOR,FW,Liverpool,28-150,1996.0,12.2,14,8,2,8,4,7,19,36.8,12,9,0,9,7,21,6,0,Matches
139,Divin Mubama,engENG,FW,Manchester City,20-190,2004.0,0.3,0,0,0,0,0,0,0,,0,0,0,0,0,0,0,0,Matches
140,Djed Spence,engENG,DF,Tottenham,24-267,2000.0,16.8,39,30,22,11,6,19,25,76.0,6,22,9,13,17,56,55,1,Matches
141,Dominic Calvert-Lewin,engENG,FW,Everton,28-048,1997.0,17.5,9,7,1,4,4,2,6,33.3,4,6,2,4,6,15,18,0,Matches
142,Dominic Solanke,engENG,FW,Tottenham,27-231,1997.0,23.5,18,11,1,12,5,4,14,28.6,10,18,7,11,0,18,22,0,Matches
143,Dominik Szoboszlai,huHUN,MF,Liverpool,24-190,2000.0,25.1,31,20,10,16,5,15,39,38.5,24,35,4,31,9,40,17,2,Matches
144,Donyell Malen,nlNED,FW,Aston Villa,26-114,1999.0,3.0,7,4,3,3,1,1,4,25.0,3,1,0,1,0,7,1,0,Matches
145,Dwight McNeil,engENG,"MF,FW",Everton,25-162,1999.0,13.2,11,6,5,4,2,8,19,42.1,11,7,0,7,5,16,1,1,Matches
146,Eberechi Eze,engENG,"MF,FW",Crystal Palace,26-308,1998.0,26.0,37,22,13,15,9,17,35,48.6,18,26,0,26,11,48,9,3,Matches
147,Eddie Nketiah,engENG,"FW,MF",Crystal Palace,25-338,1999.0,9.8,12,5,6,2,4,5,11,45.5,6,10,1,9,2,14,11,0,Matches
148,Ederson,brBRA,GK,Manchester City,31-259,1993.0,22.8,0,0,0,0,0,0,2,0.0,2,0,0,0,1,1,9,2,Matches
149,Edmond-Paris Maghoma,engENG,"MF,FW",Brentford,23-360,2001.0,1.3,2,1,0,2,0,1,3,33.3,2,2,2,0,1,3,2,0,Matches
150,Edson Álvarez,mxMEX,MF,West Ham,27-191,1997.0,18.1,44,23,24,12,8,15,33,45.5,18,21,8,13,16,60,39,1,Matches
151,Eiran Cashin,ieIRL,DF,Brighton,23-175,2001.0,0.2,0,0,0,0,0,0,1,0.0,1,0,0,0,0,0,2,0,Matches
152,Elliot Anderson,engENG,MF,Nott'ham Forest,22-178,2002.0,26.4,79,50,48,24,7,42,94,44.7,52,41,8,33,28,107,62,3,Matches
153,Emerson Palmieri,itITA,DF,West Ham,30-273,1994.0,22.4,57,29,35,18,4,25,44,56.8,19,32,8,24,20,77,58,0,Matches
154,Emi Buendía,arARG,"MF,FW",Aston Villa,28-129,1996.0,1.1,6,6,3,2,1,0,5,0.0,5,5,1,4,0,6,2,0,Matches
155,Emil Krafth,seSWE,DF,Newcastle Utd,30-274,1994.0,3.2,4,2,2,1,1,2,3,66.7,1,5,4,1,2,6,11,0,Matches
156,Emile Smith Rowe,engENG,MF,Fulham,24-279,2000.0,20.6,30,17,7,13,10,8,24,33.3,16,20,2,18,11,41,15,0,Matches
157,Emiliano Martínez,arARG,GK,Aston Villa,32-243,1992.0,32.0,3,3,3,0,0,2,2,100.0,0,1,0,1,0,3,16,6,Matches
158,Emmanuel Agbadou,ciCIV,DF,Wolves,27-320,1997.0,12.7,27,18,18,9,0,11,17,64.7,6,16,12,4,9,36,77,0,Matches
159,Enes Ünal,trTUR,"FW,MF",Bournemouth,27-358,1997.0,3.8,1,0,0,0,1,0,3,0.0,3,1,0,1,0,1,6,0,Matches
160,Enzo Fernández,arARG,MF,Chelsea,24-106,2001.0,28.8,61,30,16,28,17,29,78,37.2,49,32,5,27,11,72,22,4,Matches
161,Eric da Silva Moreira,deGER,"MF,DF",Nott'ham Forest,19-000,2006.0,0.3,2,2,2,0,0,2,6,33.3,4,0,0,0,1,3,0,0,Matches
162,Erling Haaland,noNOR,FW,Manchester City,24-286,2000.0,27.6,9,5,3,3,3,2,6,33.3,4,11,1,10,5,14,23,0,Matches
163,Ethan Nwaneri,engENG,"FW,MF",Arsenal,18-043,2007.0,9.1,11,7,4,4,3,7,18,38.9,11,8,2,6,2,13,4,1,Matches
164,Ethan Pinnock,jmJAM,DF,Brentford,31-339,1993.0,21.3,35,19,15,16,4,13,24,54.2,11,29,18,11,24,59,142,4,Matches
165,Evan Ferguson,ieIRL,FW,Brighton,20-196,2004.0,2.7,4,3,0,3,1,2,5,40.0,3,3,1,2,0,4,4,0,Matches
166,Evan Ferguson,ieIRL,FW,West Ham,20-196,2004.0,1.6,2,0,0,1,1,0,0,,0,2,1,1,1,3,1,0,Matches
167,Evanilson,brBRA,FW,Bournemouth,25-209,1999.0,21.9,14,9,6,5,3,6,10,60.0,4,10,2,8,0,14,20,0,Matches
168,Ezri Konsa,engENG,DF,Aston Villa,27-192,1997.0,28.6,32,17,19,9,4,18,22,81.8,4,17,9,8,21,53,95,3,Matches
169,Fabian Schär,chSUI,DF,Newcastle Utd,33-134,1991.0,28.6,32,19,15,15,2,14,34,41.2,20,36,24,12,40,72,113,3,Matches
170,Fabio Carvalho,ptPOR,"FW,MF",Brentford,22-246,2002.0,5.1,13,9,4,4,5,6,13,46.2,7,6,1,5,3,16,2,0,Matches
171,Facundo Buonanotte,arARG,"FW,MF",Leicester City,20-131,2004.0,16.4,53,32,17,22,14,21,67,31.3,46,32,6,26,11,64,14,0,Matches
172,Federico Chiesa,itITA,FW,Liverpool,27-190,1997.0,0.4,0,0,0,0,0,0,2,0.0,2,1,0,1,0,0,0,0,Matches
173,Ferdi Kadioglu,trTUR,"DF,MF",Brighton,25-208,1999.0,4.3,10,6,4,5,1,6,15,40.0,9,2,2,0,8,18,17,0,Matches
174,Filip Jørgensen,dkDEN,GK,Chelsea,23-017,2002.0,6.0,0,0,0,0,0,0,0,,0,0,0,0,0,0,0,3,Matches
175,Flynn Downes,engENG,MF,Southampton,26-103,1999.0,19.9,43,23,19,20,4,14,32,43.8,18,22,6,16,30,73,36,4,Matches
176,Frank Onyeka,ngNGA,MF,Brentford,27-122,1998.0,0.3,0,0,0,0,0,0,0,,0,0,0,0,0,0,0,0,Matches
177,Fraser Forster,engENG,GK,Tottenham,37-047,1988.0,7.0,0,0,0,0,0,0,1,0.0,1,0,0,0,0,0,7,3,Matches
178,Gabriel Jesus,brBRA,FW,Arsenal,28-030,1997.0,6.8,10,6,4,3,3,4,9,44.4,5,10,1,9,4,14,8,0,Matches
179,Gabriel Magalhães,brBRA,DF,Arsenal,27-135,1997.0,26.3,25,15,12,8,5,12,16,75.0,4,42,29,13,16,41,93,2,Matches
180,Gabriel Martinelli,brBRA,"FW,MF",Arsenal,23-319,2001.0,21.7,19,14,7,5,7,6,22,27.3,16,10,0,10,4,23,15,0,Matches
181,George Edmundson,engENG,DF,Ipswich Town,27-245,1997.0,0.0,0,0,0,0,0,0,0,,0,0,0,0,0,0,0,0,Matches
182,George Hirst,sctSCO,FW,Ipswich Town,26-077,1999.0,5.2,3,3,1,0,2,1,3,33.3,2,1,1,0,2,5,8,0,Matches
183,Georginio Rutter,frFRA,"MF,FW",Brighton,23-013,2002.0,18.4,39,15,13,18,8,14,36,38.9,22,20,3,17,10,49,13,2,Matches
184,Gonçalo Guedes,ptPOR,"MF,FW",Wolves,28-155,1996.0,8.7,14,4,2,5,7,3,15,20.0,12,9,0,9,5,19,3,0,Matches
185,Guglielmo Vicario,itITA,GK,Tottenham,28-208,1996.0,22.0,0,0,0,0,0,0,0,,0,0,0,0,1,1,14,5,Matches
186,Guido Rodríguez,arARG,MF,West Ham,31-021,1994.0,11.3,30,16,19,11,0,14,30,46.7,16,21,9,12,12,42,28,1,Matches
187,Gustavo Nunes,brBRA,"MF,FW",Brentford,19-164,2005.0,0.0,0,0,0,0,0,0,0,,0,0,0,0,0,0,1,0,Matches
188,Hamza Choudhury,bdBAN,"MF,DF",Leicester City,27-214,1997.0,1.5,1,1,1,0,0,1,3,33.3,2,4,2,2,5,6,2,0,Matches
189,Harrison Armstrong,engENG,MF,Everton,18-104,2007.0,0.5,0,0,0,0,0,0,1,0.0,1,0,0,0,0,0,1,0,Matches
190,Harrison Reed,engENG,MF,Fulham,30-096,1995.0,1.0,6,3,3,2,1,1,3,33.3,2,1,0,1,1,7,3,0,Matches
191,Harry Amass,engENG,DF,Manchester Utd,18-048,2007.0,1.8,4,1,4,0,0,1,3,33.3,2,3,0,3,1,5,8,0,Matches
192,Harry Clarke,engENG,DF,Ipswich Town,24-062,2001.0,4.2,5,3,3,2,0,3,6,50.0,3,5,4,1,4,9,14,3,Matches
193,Harry Maguire,engENG,DF,Manchester Utd,32-059,1993.0,16.5,26,13,20,5,1,13,17,76.5,4,14,12,2,37,63,71,1,Matches
194,Harry Toffolo,engENG,DF,Nott'ham Forest,29-257,1995.0,1.5,5,3,3,1,1,3,4,75.0,1,2,2,0,2,7,12,0,Matches
195,Harry Wilson,wlsWAL,"FW,MF",Fulham,28-042,1997.0,10.4,13,8,8,3,2,9,15,60.0,6,13,1,12,5,18,5,1,Matches
196,Harry Winks,engENG,MF,Leicester City,29-090,1996.0,17.1,24,11,12,10,2,13,30,43.3,17,19,7,12,9,33,20,0,Matches
197,Harvey Barnes,engENG,FW,Newcastle Utd,27-145,1997.0,15.7,16,9,4,6,6,3,7,42.9,4,7,1,6,6,22,12,1,Matches
198,Harvey Elliott,engENG,"MF,FW",Liverpool,22-029,2003.0,2.2,4,3,2,1,1,1,4,25.0,3,4,1,3,1,5,2,0,Matches
199,Hwang Hee-chan,krKOR,"MF,FW",Wolves,29-097,1996.0,7.2,6,4,2,1,3,2,6,33.3,4,9,0,9,2,8,11,0,Matches
200,Hákon Rafn Valdimarsson,isISL,GK,Brentford,23-202,2001.0,1.6,0,0,0,0,0,0,0,,0,0,0,0,0,0,2,0,Matches
201,Ian Maatsen,nlNED,DF,Aston Villa,23-054,2002.0,9.9,25,13,14,8,3,14,20,70.0,6,10,0,10,15,40,30,2,Matches
202,Ibrahim Sangaré,ciCIV,MF,Nott'ham Forest,27-152,1997.0,3.3,18,10,5,12,1,4,10,40.0,6,5,0,5,3,21,4,0,Matches
203,Ibrahima Konaté,frFRA,DF,Liverpool,25-343,1999.0,25.8,36,25,24,11,1,24,34,70.6,10,27,15,12,12,48,124,2,Matches
204,Idrissa Gana Gueye,snSEN,MF,Everton,35-219,1989.0,30.1,123,74,57,51,15,54,87,62.1,33,44,9,35,41,164,30,1,Matches
205,Igor,brBRA,DF,Brighton,27-085,1998.0,10.0,4,4,2,1,1,4,10,40.0,6,23,14,9,4,8,39,1,Matches
206,Iliman Ndiaye,snSEN,FW,Everton,25-058,2000.0,24.0,47,25,18,15,14,19,44,43.2,25,25,4,21,17,64,22,1,Matches
207,Illia Zabarnyi,uaUKR,DF,Bournemouth,22-244,2002.0,30.6,46,32,26,19,1,30,43,69.8,13,33,20,13,35,81,159,2,Matches
208,Ismaila Sarr,snSEN,"MF,FW",Crystal Palace,27-067,1998.0,26.6,21,10,9,9,3,7,23,30.4,16,22,7,15,8,29,34,0,Matches
209,Issa Diop,frFRA,DF,Fulham,28-114,1997.0,14.9,26,12,18,8,0,13,18,72.2,5,10,7,3,9,35,72,2,Matches
210,Jack Clarke,engENG,"FW,MF",Ipswich Town,24-161,2000.0,11.5,28,17,11,9,8,16,31,51.6,15,6,0,6,7,35,29,1,Matches
211,Jack Grealish,engENG,"FW,MF",Manchester City,29-235,1995.0,8.0,9,5,4,2,3,2,5,40.0,3,12,2,10,2,11,5,1,Matches
212,Jack Harrison,engENG,FW,Everton,28-164,1996.0,21.0,30,21,12,11,7,14,40,35.0,26,18,2,16,9,39,32,2,Matches
213,Jack Hinshelwood,engENG,"DF,MF",Brighton,20-022,2005.0,18.6,26,18,8,10,8,11,26,42.3,15,8,3,5,14,40,36,1,Matches
214,Jack Stephens,engENG,DF,Southampton,31-096,1994.0,12.9,31,18,23,8,0,15,26,57.7,11,14,9,5,11,42,44,2,Matches
215,Jack Taylor,ieIRL,MF,Ipswich Town,26-314,1998.0,7.6,17,8,5,9,3,11,22,50.0,11,9,2,7,7,24,22,0,Matches
216,Jacob Greaves,engENG,DF,Ipswich Town,24-233,2000.0,20.5,31,14,14,16,1,17,26,65.4,9,36,24,12,18,49,119,2,Matches
217,Jacob Murphy,engENG,FW,Newcastle Utd,30-068,1995.0,23.2,22,15,7,9,6,16,30,53.3,14,31,0,31,11,33,25,1,Matches
218,Jacob Ramsey,engENG,"FW,MF",Aston Villa,23-340,2001.0,16.5,29,15,14,9,6,10,20,50.0,10,21,3,18,7,36,8,1,Matches
219,Jaden Philogene Bidace,engENG,"FW,MF",Aston Villa,23-084,2002.0,3.7,11,5,4,7,0,4,6,66.7,2,5,0,5,3,14,2,1,Matches
220,Jaden Philogene Bidace,engENG,"FW,DF",Ipswich Town,23-084,2002.0,5.3,14,7,6,6,2,8,15,53.3,7,11,1,10,10,24,9,1,Matches
221,Jadon Sancho,engENG,FW,Chelsea,25-039,2000.0,18.5,10,6,3,2,5,5,12,41.7,7,9,0,9,2,12,6,2,Matches
222,Jahmai Simpson-Pusey,engENG,DF,Manchester City,19-180,2005.0,1.1,1,0,1,0,0,0,1,0.0,1,1,1,0,0,1,2,0,Matches
223,Jake Evans,,FW,Leicester City,,,0.0,0,0,0,0,0,0,0,,0,0,0,0,0,0,0,0,Matches
224,Jake O'Brien,ieIRL,DF,Everton,23-353,2001.0,14.5,20,14,16,4,0,14,22,63.6,8,15,4,11,4,24,78,0,Matches
225,Jakub Kiwior,plPOL,DF,Arsenal,25-077,2000.0,8.5,12,6,6,5,1,8,11,72.7,3,8,5,3,2,14,35,2,Matches
226,Jakub Moder,plPOL,MF,Brighton,26-026,1999.0,0.1,1,0,1,0,0,0,2,0.0,2,0,0,0,0,1,3,0,Matches
227,Jakub Stolarczyk,plPOL,GK,Leicester City,24-135,2000.0,6.0,2,1,2,0,0,1,2,50.0,1,0,0,0,0,2,5,0,Matches
228,James Bree,engENG,DF,Southampton,27-204,1997.0,9.9,15,10,5,9,1,7,17,41.2,10,8,3,5,8,23,24,0,Matches
229,James Garner,engENG,"MF,DF",Everton,24-051,2001.0,13.7,37,23,22,13,2,17,33,51.5,16,14,3,11,16,53,35,0,Matches
230,James Hill,engENG,DF,Bournemouth,23-113,2002.0,5.0,15,8,6,6,3,3,11,27.3,8,5,0,5,9,24,31,0,Matches
231,James Justin,engENG,DF,Leicester City,27-069,1998.0,28.7,48,29,25,18,5,27,49,55.1,22,39,13,26,42,90,125,3,Matches
232,James Maddison,engENG,MF,Tottenham,28-161,1996.0,20.1,31,19,8,16,7,9,29,31.0,20,15,4,11,12,43,19,1,Matches
233,James Mcatee,engENG,"MF,FW",Manchester City,22-197,2002.0,3.4,4,2,0,4,0,1,7,14.3,6,8,0,8,2,6,1,0,Matches
234,James Milner,engENG,MF,Brighton,39-119,1986.0,1.9,5,2,1,3,1,3,3,100.0,0,4,2,2,2,7,2,1,Matches
235,James Tarkowski,engENG,DF,Everton,32-165,1992.0,32.5,64,40,39,22,3,24,39,61.5,15,57,42,15,41,105,213,4,Matches
236,James Ward-Prowse,engENG,MF,Nott'ham Forest,30-183,1994.0,4.4,4,1,1,3,0,2,2,100.0,0,3,2,1,5,9,8,0,Matches
237,James Ward-Prowse,engENG,MF,West Ham,30-183,1994.0,8.9,13,9,7,3,3,3,12,25.0,9,6,3,3,5,18,13,0,Matches
238,Jamie Vardy,engENG,FW,Leicester City,38-112,1987.0,28.6,18,13,6,7,5,4,13,30.8,9,8,4,4,3,21,23,0,Matches
239,Jan Bednarek,plPOL,DF,Southampton,29-021,1996.0,26.1,35,18,22,13,0,15,30,50.0,15,43,32,11,53,88,173,5,Matches
240,Jan Paul van Hecke,nlNED,DF,Brighton,24-329,2000.0,28.9,39,25,20,18,1,20,37,54.1,17,32,19,13,23,62,128,2,Matches
241,Jannik Vestergaard,dkDEN,DF,Leicester City,32-273,1992.0,15.5,22,10,16,6,0,9,15,60.0,6,21,14,7,16,38,74,1,Matches
242,Jarell Quansah,engENG,DF,Liverpool,22-094,2003.0,3.5,10,7,8,2,0,5,7,71.4,2,5,5,0,5,15,15,0,Matches
243,Jarrad Branthwaite,engENG,DF,Everton,22-310,2002.0,25.1,35,20,26,9,0,19,26,73.1,7,29,21,8,23,58,181,4,Matches
244,Jarrod Bowen,engENG,"FW,MF",West Ham,28-134,1996.0,29.2,36,23,13,9,14,17,37,45.9,20,21,3,18,16,52,23,0,Matches
245,Jason Steele,engENG,GK,Brighton,34-258,1990.0,2.0,0,0,0,0,0,0,0,,0,0,0,0,0,0,1,0,Matches
246,Jay Robinson,engENG,MF,Southampton,18-049,2007.0,0.0,1,0,1,0,0,0,0,,0,0,0,0,0,1,0,0,Matches
247,Jay Stansfield,engENG,MF,Fulham,22-160,2002.0,0.0,0,0,0,0,0,0,0,,0,0,0,0,0,0,0,0,Matches
248,Jayden Danns,engENG,MF,Liverpool,19-107,2006.0,0.1,0,0,0,0,0,0,1,0.0,1,0,0,0,0,0,0,0,Matches
249,Jayden Meghoma,engENG,DF,Brentford,18-309,2006.0,0.1,0,0,0,0,0,0,0,,0,0,0,0,0,0,0,0,Matches
250,Jean-Clair Todibo,frFRA,DF,West Ham,25-124,1999.0,16.5,36,22,24,12,0,23,30,76.7,7,23,12,11,20,56,69,3,Matches
251,Jean-Philippe Mateta,frFRA,FW,Crystal Palace,27-309,1997.0,27.1,17,12,4,11,2,3,16,18.8,13,16,3,13,2,19,22,0,Matches
252,Jean-Ricner Bellegarde,frFRA,"MF,FW",Wolves,26-310,1998.0,17.2,37,22,17,17,3,13,19,68.4,6,19,3,16,10,47,17,1,Matches
253,Jefferson Lerma,coCOL,"MF,DF",Crystal Palace,30-190,1994.0,22.6,30,15,12,14,4,17,33,51.5,16,32,15,17,36,66,63,1,Matches
254,Jeffrey Schlupp,ghGHA,"MF,DF",Crystal Palace,32-131,1992.0,1.1,2,0,1,0,1,0,3,0.0,3,6,0,6,0,2,2,0,Matches
255,Jens Cajuste,seSWE,MF,Ipswich Town,25-266,1999.0,19.7,39,19,18,20,1,19,47,40.4,28,24,9,15,25,64,32,2,Matches
256,Jeremy Doku,beBEL,"FW,MF",Manchester City,22-341,2002.0,15.5,28,19,9,12,7,7,14,50.0,7,10,1,9,4,32,2,0,Matches
257,Jeremy Monga,,FW,Leicester City,,,0.3,0,0,0,0,0,0,0,,0,1,1,0,0,0,0,0,Matches
258,Jeremy Sarmiento,ecECU,MF,Brighton,22-321,2002.0,0.1,0,0,0,0,0,0,0,,0,0,0,0,0,0,0,0,Matches
259,Jesper Lindstrøm,dkDEN,FW,Everton,25-063,2000.0,13.8,45,25,24,19,2,19,55,34.5,36,15,3,12,12,57,17,0,Matches
260,Joachim Andersen,dkDEN,DF,Crystal Palace,28-337,1996.0,1.0,1,1,1,0,0,1,2,50.0,1,0,0,0,0,1,7,0,Matches
261,Joachim Andersen,dkDEN,DF,Fulham,28-337,1996.0,24.7,24,17,18,5,1,13,20,65.0,7,31,25,6,30,54,157,1,Matches
262,Joe Aribo,ngNGA,"MF,DF",Southampton,28-286,1996.0,21.2,44,30,15,23,6,17,34,50.0,17,24,9,15,20,64,29,3,Matches
263,Joe Gomez,engENG,DF,Liverpool,27-345,1997.0,5.8,13,10,5,7,1,11,16,68.8,5,9,6,3,7,20,20,2,Matches
264,Joe Lumley,engENG,GK,Southampton,30-077,1995.0,3.0,0,0,0,0,0,0,0,,0,0,0,0,0,0,3,3,Matches
265,Joe Willock,engENG,"MF,FW",Newcastle Utd,25-256,1999.0,10.6,25,14,14,8,3,18,28,64.3,10,22,5,17,5,30,7,0,Matches
266,Joel Ward,engENG,DF,Crystal Palace,35-186,1989.0,0.0,0,0,0,0,0,0,0,,0,0,0,0,0,0,0,0,Matches
267,Joelinton,brBRA,"MF,FW",Newcastle Utd,28-262,1996.0,26.6,57,35,23,23,11,25,44,56.8,19,37,7,30,23,80,47,2,Matches
268,John McGinn,sctSCO,"MF,FW",Aston Villa,30-197,1994.0,22.1,31,22,10,13,8,11,26,42.3,15,20,2,18,14,45,14,3,Matches
269,John Stones,engENG,"DF,MF",Manchester City,30-340,1994.0,6.1,6,2,3,2,1,5,5,100.0,0,5,3,2,4,10,19,1,Matches
270,Jonny Evans,nirNIR,DF,Manchester Utd,37-120,1988.0,3.2,7,5,4,3,0,2,4,50.0,2,2,1,1,4,11,13,0,Matches
271,Jordan Ayew,ghGHA,"FW,MF",Leicester City,33-234,1991.0,15.1,24,13,7,12,5,6,19,31.6,13,15,0,15,12,36,16,0,Matches
272,Jordan Ayew,ghGHA,"FW,MF",Crystal Palace,33-234,1991.0,0.2,1,0,0,0,1,0,0,,0,0,0,0,0,1,0,0,Matches
273,Jordan Pickford,engENG,GK,Everton,31-057,1994.0,34.0,1,0,1,0,0,1,2,50.0,1,0,0,0,1,2,29,2,Matches
274,Jorge Cuenca,esESP,DF,Fulham,25-167,1999.0,2.9,2,2,2,0,0,2,5,40.0,3,3,3,0,2,4,21,0,Matches
275,Jorginho,itITA,MF,Arsenal,33-134,1991.0,7.8,12,4,1,7,4,8,20,40.0,12,3,0,3,7,19,2,2,Matches
276,Joshua Acheampong,engENG,DF,Chelsea,18-363,2006.0,1.9,2,1,2,0,0,2,2,100.0,0,1,0,1,1,3,2,0,Matches
277,Joshua King,engENG,"MF,FW",Fulham,18-120,2007.0,0.9,5,3,2,3,0,0,2,0.0,2,2,0,2,1,6,1,0,Matches
278,Joshua Zirkzee,nlNED,"FW,MF",Manchester Utd,23-346,2001.0,15.6,14,8,3,8,3,5,10,50.0,5,15,4,11,6,20,8,1,Matches
279,José Sá,ptPOR,GK,Wolves,32-106,1993.0,27.0,2,2,2,0,0,2,2,100.0,0,0,0,0,0,2,14,1,Matches
280,Jota Silva,ptPOR,"FW,MF",Nott'ham Forest,25-275,1999.0,9.4,25,13,12,11,2,5,25,20.0,20,9,1,8,12,37,17,0,Matches
281,João Félix,ptPOR,"FW,MF",Chelsea,25-174,1999.0,4.1,8,3,2,5,1,5,9,55.6,4,2,0,2,3,11,2,0,Matches
282,João Gomes,brBRA,MF,Wolves,24-080,2001.0,30.9,105,62,53,48,4,42,102,41.2,60,42,4,38,25,130,32,0,Matches
283,João Pedro,brBRA,"FW,MF",Brighton,23-219,2001.0,21.6,16,12,6,6,4,4,11,36.4,7,12,0,12,9,25,12,0,Matches
284,Joël Veltman,nlNED,DF,Brighton,33-108,1992.0,18.3,42,28,23,16,3,30,51,58.8,21,22,7,15,18,60,66,0,Matches
285,Joško Gvardiol,hrCRO,DF,Manchester City,23-100,2002.0,33.4,51,34,24,17,10,19,37,51.4,18,40,20,20,38,89,117,8,Matches
286,Julian Araujo,mxMEX,DF,Bournemouth,23-263,2001.0,4.0,7,3,3,4,0,4,10,40.0,6,3,0,3,4,11,14,0,Matches
287,Julio Enciso,pyPAR,"MF,FW",Brighton,21-100,2004.0,3.3,0,0,0,0,0,0,2,0.0,2,2,0,2,0,0,1,0,Matches
288,Julio Enciso,pyPAR,"FW,MF",Ipswich Town,21-100,2004.0,6.9,11,8,2,6,3,4,9,44.4,5,2,0,2,1,12,3,0,Matches
289,Julio Soler,arARG,FW,Bournemouth,20-076,2005.0,0.0,1,1,1,0,0,1,1,100.0,0,1,0,1,0,1,0,0,Matches
290,Jurriën Timber,nlNED,DF,Arsenal,23-320,2001.0,26.9,58,38,17,30,11,18,27,66.7,9,19,4,15,22,80,44,1,Matches
291,Justin Devenny,nirNIR,MF,Crystal Palace,21-204,2003.0,4.8,14,9,6,7,1,7,14,50.0,7,3,0,3,0,14,10,0,Matches
292,Justin Kluivert,nlNED,"MF,FW",Bournemouth,25-363,1999.0,23.3,21,9,4,10,7,4,20,20.0,16,24,0,24,13,34,23,1,Matches
293,Jáder Durán,coCOL,FW,Aston Villa,21-141,2003.0,7.1,8,7,1,2,5,1,4,25.0,3,5,0,5,0,8,13,0,Matches
294,Jørgen Strand Larsen,noNOR,FW,Wolves,25-086,2000.0,27.4,9,6,2,3,4,4,27,14.8,23,18,4,14,5,14,27,0,Matches
295,Kaelan Casey,engENG,DF,West Ham,20-187,2004.0,0.0,0,0,0,0,0,0,0,,0,0,0,0,0,0,1,0,Matches
296,Kai Havertz,deGER,"FW,MF",Arsenal,25-326,1999.0,20.4,16,9,3,6,7,4,15,26.7,11,22,4,18,6,22,31,1,Matches
297,Kalvin Phillips,engENG,MF,Ipswich Town,29-152,1995.0,13.5,34,19,8,19,7,15,38,39.5,23,35,6,29,19,53,37,2,Matches
298,Kamaldeen Sulemana,ghGHA,"FW,MF",Southampton,23-077,2002.0,12.5,16,14,6,4,6,8,13,61.5,5,9,0,9,6,22,9,0,Matches
299,Kaoru Mitoma,jpJPN,"FW,MF",Brighton,27-348,1997.0,28.0,43,26,14,13,16,18,46,39.1,28,46,3,43,13,56,10,0,Matches
300,Kasey McAteer,ieIRL,"FW,MF",Leicester City,23-162,2001.0,5.9,12,9,6,4,2,7,19,36.8,12,12,1,11,3,15,11,0,Matches
301,Keane Lewis-Potter,engENG,"DF,FW",Brentford,24-070,2001.0,30.7,44,26,23,15,6,26,43,60.5,17,24,9,15,19,63,71,3,Matches
302,Kenny Tete,nlNED,DF,Fulham,29-206,1995.0,16.0,49,34,23,14,12,20,32,62.5,12,20,6,14,28,77,51,0,Matches
303,Kepa Arrizabalaga,esESP,GK,Bournemouth,30-212,1994.0,27.0,1,0,1,0,0,0,1,0.0,1,1,0,1,0,1,13,3,Matches
304,Kevin Danso,atAUT,DF,Tottenham,26-226,1998.0,5.4,5,4,2,3,0,4,6,66.7,2,6,6,0,2,7,35,1,Matches
305,Kevin De Bruyne,beBEL,"MF,FW",Manchester City,33-309,1991.0,17.1,17,9,7,5,5,5,23,21.7,18,8,0,8,7,24,10,1,Matches
306,Kevin Schade,deGER,FW,Brentford,23-157,2001.0,22.2,34,23,14,9,11,12,20,60.0,8,15,2,13,5,39,31,0,Matches
307,Kieran Tierney,sctSCO,"DF,FW",Arsenal,27-332,1997.0,2.0,5,4,3,1,1,3,5,60.0,2,0,0,0,2,7,5,0,Matches
308,Kieran Trippier,engENG,DF,Newcastle Utd,34-226,1990.0,13.2,36,19,18,12,6,21,34,61.8,13,9,3,6,11,47,41,0,Matches
309,Kiernan Dewsbury-Hall,engENG,"MF,FW",Chelsea,26-239,1998.0,2.9,8,5,1,1,6,4,6,66.7,2,2,0,2,1,9,8,1,Matches
310,Kim Jisoo,krKOR,DF,Brentford,20-130,2004.0,0.3,0,0,0,0,0,0,0,,0,0,0,0,0,0,2,0,Matches
311,Kobbie Mainoo,engENG,MF,Manchester Utd,20-014,2005.0,15.7,39,24,16,11,12,21,34,61.8,13,16,2,14,19,58,7,1,Matches
312,Konstantinos Mavropanos,grGRE,DF,West Ham,27-143,1997.0,21.6,32,22,22,9,1,14,25,56.0,11,23,17,6,38,70,117,1,Matches
313,Kosta Nedeljković,rsSRB,DF,Aston Villa,19-138,2005.0,1.4,7,5,1,3,3,2,3,66.7,1,1,0,1,0,7,3,0,Matches
314,Kostas Tsimikas,grGRE,DF,Liverpool,28-356,1996.0,7.4,27,17,13,11,3,13,19,68.4,6,5,2,3,10,37,16,0,Matches
315,Kristoffer Ajer,noNOR,DF,Brentford,27-016,1998.0,15.5,25,17,14,10,1,14,26,53.8,12,17,4,13,12,37,49,0,Matches
316,Kyle Walker,engENG,DF,Manchester City,34-340,1990.0,10.8,17,10,7,7,3,14,26,53.8,12,13,4,9,3,20,13,1,Matches
317,Kyle Walker-Peters,engENG,DF,Southampton,28-020,1997.0,31.4,43,28,22,14,7,16,34,47.1,18,25,14,11,18,61,89,1,Matches
318,Lamare Bogarde,nlNED,"DF,MF",Aston Villa,21-118,2004.0,5.3,14,6,6,6,2,10,16,62.5,6,5,3,2,1,15,13,0,Matches
319,Leandro Trossard,beBEL,FW,Arsenal,30-150,1994.0,25.2,25,16,5,14,6,9,31,29.0,22,28,0,28,9,34,17,0,Matches
320,Leif Davis,engENG,DF,Ipswich Town,25-111,2000.0,28.5,45,26,32,9,4,29,46,63.0,17,24,8,16,25,70,72,3,Matches
321,Leny Yoro,frFRA,DF,Manchester Utd,19-171,2005.0,11.9,25,10,16,8,1,11,17,64.7,6,5,3,2,17,42,40,0,Matches
322,Leon Bailey,jmJAM,"FW,MF",Aston Villa,27-267,1997.0,12.6,6,4,1,3,2,2,10,20.0,8,6,0,6,3,9,12,0,Matches
323,Lesley Ugochukwu,frFRA,MF,Southampton,21-038,2004.0,16.1,46,22,14,28,4,17,32,53.1,15,25,9,16,12,58,20,1,Matches
324,Levi Colwill,engENG,DF,Chelsea,22-066,2003.0,31.0,40,28,20,17,3,16,25,64.0,9,34,24,10,31,71,99,4,Matches
325,Lewis Cook,engENG,"MF,DF",Bournemouth,28-089,1997.0,30.3,77,41,40,34,3,35,65,53.8,30,28,10,18,40,117,64,0,Matches
326,Lewis Dunk,engENG,DF,Brighton,33-163,1991.0,22.1,17,10,8,7,2,11,19,57.9,8,26,17,9,12,29,74,2,Matches
327,Lewis Hall,engENG,DF,Newcastle Utd,20-237,2004.0,24.3,58,41,28,22,8,40,74,54.1,34,33,18,15,18,76,75,3,Matches
328,Lewis Miley,engENG,MF,Newcastle Utd,19-002,2006.0,2.8,11,9,4,6,1,6,11,54.5,5,5,1,4,2,13,5,2,Matches
329,Lewis Orford,engENG,MF,West Ham,19-074,2006.0,0.5,0,0,0,0,0,0,0,,0,1,0,1,1,1,0,0,Matches
330,Liam Delap,engENG,FW,Ipswich Town,22-084,2003.0,26.9,10,7,3,2,5,2,14,14.3,12,8,0,8,2,12,28,0,Matches
331,Lisandro Martínez,arARG,DF,Manchester Utd,27-105,1998.0,19.5,40,24,25,12,3,21,36,58.3,15,22,8,14,32,72,57,1,Matches
332,Lloyd Kelly,engENG,DF,Newcastle Utd,26-209,1998.0,3.4,5,4,4,1,0,1,1,100.0,0,6,4,2,1,6,17,0,Matches
333,Lucas Bergvall,seSWE,MF,Tottenham,19-090,2006.0,13.5,39,19,14,20,5,17,32,53.1,15,18,8,10,24,63,22,3,Matches
334,Lucas Digne,frFRA,DF,Aston Villa,31-287,1993.0,24.9,62,36,37,16,9,42,62,67.7,20,23,4,19,25,87,82,1,Matches
335,Lucas Paquetá,brBRA,"MF,FW",West Ham,27-249,1997.0,25.1,63,35,23,29,11,24,49,49.0,25,27,4,23,17,80,34,6,Matches
336,Luis Díaz,coCOL,FW,Liverpool,28-110,1997.0,24.7,33,21,10,17,6,13,34,38.2,21,18,0,18,7,40,7,1,Matches
337,Luis Guilherme,brBRA,"MF,FW",West Ham,19-083,2006.0,1.5,1,0,1,0,0,0,3,0.0,3,7,0,7,3,4,2,0,Matches
338,Luis Sinisterra,coCOL,"FW,MF",Bournemouth,25-320,1999.0,2.6,7,2,3,2,2,0,4,0.0,4,3,0,3,1,8,8,0,Matches
339,Luke Shaw,engENG,DF,Manchester Utd,29-295,1995.0,1.9,3,2,2,1,0,1,1,100.0,0,2,1,1,2,5,4,0,Matches
340,Luke Thomas,engENG,DF,Leicester City,23-327,2001.0,8.7,24,20,19,4,1,18,32,56.3,14,13,5,8,15,39,38,1,Matches
341,Luke Woolfenden,engENG,DF,Ipswich Town,26-194,1998.0,12.2,9,6,5,4,0,2,5,40.0,3,21,14,7,18,27,70,0,Matches
342,Mads Hermansen,dkDEN,GK,Leicester City,24-296,2000.0,26.5,1,1,1,0,0,1,1,100.0,0,1,0,1,0,1,13,4,Matches
343,Mads Roerslev,dkDEN,DF,Brentford,25-313,1999.0,12.2,18,8,14,3,1,11,28,39.3,17,12,5,7,4,22,35,0,Matches
344,Malo Gusto,frFRA,DF,Chelsea,21-349,2003.0,20.2,43,28,26,15,2,24,47,51.1,23,29,8,21,23,66,46,5,Matches
345,Manuel Akanji,chSUI,DF,Manchester City,29-288,1995.0,19.4,16,11,9,4,3,8,13,61.5,5,11,8,3,7,23,57,3,Matches
346,Manuel Ugarte Ribeiro,uyURU,MF,Manchester Utd,24-022,2001.0,18.0,70,43,31,31,8,25,60,41.7,35,27,3,24,25,95,16,1,Matches
347,Marc Cucurella,esESP,DF,Chelsea,26-285,1998.0,29.2,58,38,29,24,5,25,50,50.0,25,40,13,27,23,81,76,3,Matches
348,Marc Guiu,esESP,FW,Chelsea,19-119,2006.0,0.8,1,1,0,1,0,1,1,100.0,0,0,0,0,0,1,0,0,Matches
349,Marc Guéhi,engENG,DF,Crystal Palace,24-294,2000.0,32.0,56,31,32,22,2,30,45,66.7,15,53,22,31,25,81,148,2,Matches
350,Marco Asensio,esESP,"MF,FW",Aston Villa,29-102,1996.0,5.3,7,5,0,7,0,3,8,37.5,5,2,0,2,1,8,3,0,Matches
351,Marcos Senesi,arARG,DF,Bournemouth,27-358,1997.0,11.3,35,21,22,11,2,14,30,46.7,16,15,7,8,11,46,54,0,Matches
352,Marcus Harness,engENG,MF,Ipswich Town,29-068,1996.0,0.5,1,0,0,0,1,0,3,0.0,3,2,1,1,0,1,1,0,Matches
353,Marcus Rashford,engENG,FW,Aston Villa,27-184,1997.0,4.9,10,7,2,3,5,4,6,66.7,2,2,0,2,1,11,3,0,Matches
354,Marcus Rashford,engENG,"FW,MF",Manchester Utd,27-184,1997.0,10.9,7,4,2,2,3,3,9,33.3,6,8,0,8,4,11,7,0,Matches
355,Marcus Tavernier,engENG,"FW,MF",Bournemouth,26-042,1999.0,17.6,39,23,13,17,9,9,25,36.0,16,15,3,12,4,43,11,0,Matches
356,Mario Lemina,gaGAB,"MF,DF",Wolves,31-244,1993.0,15.2,51,31,27,19,5,20,29,69.0,9,12,7,5,27,78,50,3,Matches
357,Mark Flekken,nlNED,GK,Brentford,31-324,1993.0,32.4,4,4,4,0,0,3,9,33.3,6,2,0,2,0,4,26,3,Matches
358,Mark Travers,ieIRL,GK,Bournemouth,25-350,1999.0,5.0,0,0,0,0,0,0,0,,0,0,0,0,0,0,5,0,Matches
359,Marshall Munetsi,zwZIM,"MF,FW",Wolves,28-315,1996.0,9.8,21,10,6,9,6,12,20,60.0,8,12,1,11,6,27,15,0,Matches
360,Martial Godo,engENG,FW,Fulham,22-050,2003.0,0.2,0,0,0,0,0,0,0,,0,1,0,1,1,1,0,0,Matches
361,Martin Dúbravka,skSVK,GK,Newcastle Utd,36-108,1989.0,10.0,0,0,0,0,0,0,0,,0,0,0,0,0,0,3,0,Matches
362,Martin Ødegaard,noNOR,MF,Arsenal,26-137,1998.0,22.7,19,11,9,7,3,4,24,16.7,20,4,0,4,4,23,4,1,Matches
363,Mason Holgate,engENG,"FW,DF",Everton,28-193,1996.0,0.1,0,0,0,0,0,0,0,,0,0,0,0,0,0,0,0,Matches
364,Mason Mount,engENG,"MF,FW",Manchester Utd,26-113,1999.0,4.2,8,2,4,4,0,6,8,75.0,2,7,1,6,2,10,0,0,Matches
365,Massimo Luongo,auAUS,MF,Ipswich Town,32-220,1992.0,2.2,8,5,6,1,1,4,7,57.1,3,4,2,2,2,10,2,0,Matches
366,Mateo Kovačić,hrCRO,MF,Manchester City,30-362,1994.0,22.8,67,38,22,38,7,30,63,47.6,33,20,0,20,20,87,20,1,Matches
367,Mateus Fernandes,ptPOR,MF,Southampton,20-297,2004.0,28.7,81,43,39,27,15,30,61,49.2,31,39,5,34,21,102,30,6,Matches
368,Matheus Cunha,brBRA,"MF,FW",Wolves,25-341,1999.0,26.9,35,21,16,15,4,11,36,30.6,25,19,1,18,17,52,23,0,Matches
369,Matheus França,brBRA,"FW,MF",Crystal Palace,21-032,2004.0,0.3,1,0,0,1,0,0,0,,0,0,0,0,0,1,0,0,Matches
370,Matheus Nunes,ptPOR,"DF,MF",Manchester City,26-249,1998.0,16.6,32,21,13,13,6,15,34,44.1,19,14,3,11,13,45,35,1,Matches
371,Mathias Jensen,dkDEN,MF,Brentford,29-122,1996.0,8.8,13,9,6,5,2,7,15,46.7,8,13,4,9,8,21,12,1,Matches
372,Mathis Amougou,frFRA,MF,Chelsea,19-105,2006.0,0.1,0,0,0,0,0,0,0,,0,0,0,0,0,0,0,0,Matches
373,Mathys Tel,frFRA,FW,Tottenham,20-006,2005.0,6.2,6,2,0,3,3,2,7,28.6,5,3,0,3,0,6,2,2,Matches
374,Mats Wieffer,nlNED,"MF,DF",Brighton,25-168,1999.0,7.7,33,19,11,18,4,16,27,59.3,11,13,1,12,11,44,17,2,Matches
375,Matt Doherty,ieIRL,DF,Wolves,33-107,1992.0,21.8,37,20,25,12,0,16,24,66.7,8,26,15,11,21,58,91,3,Matches
376,Matt O'Riley,dkDEN,MF,Brighton,24-163,2000.0,8.4,15,9,4,8,3,4,12,33.3,8,6,3,3,12,27,7,1,Matches
377,Matt Targett,engENG,DF,Newcastle Utd,29-227,1995.0,0.2,0,0,0,0,0,0,1,0.0,1,0,0,0,1,1,1,0,Matches
378,Matthijs de Ligt,nlNED,DF,Manchester Utd,25-264,1999.0,23.2,30,22,17,12,1,23,32,71.9,9,29,21,8,33,63,92,0,Matches
379,Matty Cash,plPOL,DF,Aston Villa,27-269,1997.0,19.0,46,26,24,19,3,23,33,69.7,10,17,6,11,21,67,55,2,Matches
380,Matz Sels,beBEL,GK,Nott'ham Forest,33-066,1992.0,34.0,1,1,1,0,0,1,1,100.0,0,0,0,0,0,1,22,1,Matches
381,Max Aarons,engENG,DF,Bournemouth,25-119,2000.0,1.0,2,2,1,1,0,1,1,100.0,0,3,1,2,1,3,0,0,Matches
382,Max Kilman,engENG,DF,West Ham,27-345,1997.0,33.2,30,17,13,14,3,19,23,82.6,4,55,37,18,37,67,191,4,Matches
383,Maxence Lacroix,frFRA,DF,Crystal Palace,25-027,2000.0,30.6,67,40,51,15,1,32,47,68.1,15,41,16,25,50,117,181,2,Matches
384,Maxwel Cornet,ciCIV,FW,Southampton,28-218,1996.0,0.8,5,5,1,4,0,0,4,0.0,4,0,0,0,0,5,2,0,Matches
385,Michael Kayode,itITA,DF,Brentford,20-297,2004.0,2.3,11,7,8,3,0,5,5,100.0,0,0,0,0,2,13,10,0,Matches
386,Michael Keane,engENG,DF,Everton,32-112,1993.0,9.5,10,7,7,2,1,7,13,53.8,6,11,7,4,10,20,55,2,Matches
387,Michail Antonio,jmJAM,FW,West Ham,35-036,1990.0,9.3,2,2,0,1,1,2,3,66.7,1,6,0,6,0,2,2,0,Matches
388,Micky van de Ven,nlNED,DF,Tottenham,24-014,2001.0,10.6,10,6,5,4,1,8,14,57.1,6,9,6,3,10,20,36,1,Matches
389,Miguel Almirón,pyPAR,FW,Newcastle Utd,31-082,1994.0,1.7,3,2,2,0,1,2,3,66.7,1,2,0,2,0,3,0,0,Matches
390,Mikel Merino,esESP,"MF,FW",Arsenal,28-315,1996.0,15.6,38,22,6,21,11,15,29,51.7,14,17,5,12,13,51,24,1,Matches
391,Mikey Moore,engENG,"FW,MF",Tottenham,17-265,2007.0,2.1,0,0,0,0,0,0,1,0.0,1,1,0,1,1,1,1,0,Matches
392,Mikkel Damsgaard,dkDEN,"MF,FW",Brentford,24-304,2000.0,28.6,74,41,27,24,23,27,71,38.0,44,34,2,32,25,99,30,2,Matches
393,Milos Kerkez,huHUN,DF,Bournemouth,21-177,2003.0,33.2,49,26,24,19,6,22,36,61.1,14,36,11,25,40,89,103,2,Matches
394,Mohamed Salah,egEGY,FW,Liverpool,32-322,1992.0,33.5,20,11,7,5,8,7,16,43.8,9,11,0,11,7,27,5,0,Matches
395,Mohammed Kudus,ghGHA,"FW,MF",West Ham,24-274,2000.0,25.9,33,19,7,16,10,10,27,37.0,17,23,1,22,4,37,8,2,Matches
396,Moisés Caicedo,ecECU,MF,Chelsea,23-182,2001.0,33.2,100,63,36,50,14,50,80,62.5,30,44,9,35,47,147,47,1,Matches
397,Morato,brBRA,DF,Nott'ham Forest,23-307,2001.0,8.9,21,13,18,2,1,13,20,65.0,7,11,4,7,10,31,71,2,Matches
398,Morgan Gibbs-White,engENG,MF,Nott'ham Forest,25-096,2000.0,27.2,39,18,14,19,6,15,30,50.0,15,14,4,10,18,57,27,1,Matches
399,Morgan Rogers,engENG,"FW,MF",Aston Villa,22-281,2002.0,30.7,35,18,13,13,9,18,38,47.4,20,24,7,17,5,40,19,2,Matches
400,Murillo,brBRA,DF,Nott'ham Forest,22-303,2002.0,32.5,52,36,37,12,3,26,45,57.8,19,66,43,23,30,82,225,3,Matches
401,Mykhailo Mudryk,uaUKR,FW,Chelsea,24-118,2001.0,1.7,2,2,2,0,0,0,0,,0,3,1,2,0,2,1,0,Matches
402,Myles Lewis-Skelly,engENG,DF,Arsenal,18-219,2006.0,12.0,21,14,10,9,2,9,9,100.0,0,1,0,1,6,27,18,0,Matches
403,Nasser Djiga,bfBFA,"DF,FW",Wolves,22-169,2002.0,0.2,0,0,0,0,0,0,0,,0,0,0,0,2,2,3,1,Matches
404,Nathan Aké,nlNED,DF,Manchester City,30-074,1995.0,7.5,9,7,7,2,0,4,6,66.7,2,7,2,5,3,12,22,1,Matches
405,Nathan Broadhead,wlsWAL,"MF,FW",Ipswich Town,27-028,1998.0,6.7,7,3,2,5,0,3,9,33.3,6,6,1,5,4,11,5,0,Matches
406,Nathan Butler-Oyedeji,engENG,FW,Arsenal,22-119,2003.0,0.1,0,0,0,0,0,0,0,,0,0,0,0,0,0,0,0,Matches
407,Nathan Collins,ieIRL,DF,Brentford,24-003,2001.0,34.0,36,21,21,11,4,21,31,67.7,10,69,49,20,32,68,209,2,Matches
408,Nathan Patterson,sctSCO,DF,Everton,23-199,2001.0,3.0,8,4,6,2,0,5,11,45.5,6,2,0,2,1,9,6,0,Matches
409,Nathan Wood-Gordon,engENG,DF,Southampton,22-337,2002.0,6.9,10,7,6,3,1,5,8,62.5,3,8,5,3,4,14,26,2,Matches
410,Nathaniel Clyne,engENG,"DF,MF",Crystal Palace,34-028,1991.0,5.4,12,8,8,3,1,6,11,54.5,5,4,2,2,3,15,14,1,Matches
411,Neco Williams,wlsWAL,DF,Nott'ham Forest,24-020,2001.0,24.8,73,44,54,14,5,43,70,61.4,27,39,9,30,24,97,119,2,Matches
412,Neto,brBRA,GK,Bournemouth,35-288,1989.0,2.0,0,0,0,0,0,0,0,,0,0,0,0,0,0,1,1,Matches
413,Nick Pope,engENG,GK,Newcastle Utd,33-014,1992.0,24.0,0,0,0,0,0,0,0,,0,1,0,1,1,1,29,5,Matches
414,Niclas Füllkrug,deGER,FW,West Ham,32-083,1993.0,6.5,2,2,0,1,1,2,3,66.7,1,1,0,1,0,2,12,0,Matches
415,Nico O’Reilly,engENG,DF,Manchester City,20-043,2005.0,5.7,9,4,3,3,3,4,8,50.0,4,5,1,4,4,13,12,0,Matches
416,Nicolas Jackson,snSEN,FW,Chelsea,23-317,2001.0,23.5,19,11,4,6,9,3,8,37.5,5,13,2,11,3,22,15,0,Matches
417,Nicolás Domínguez,arARG,"MF,FW",Nott'ham Forest,26-309,1998.0,18.5,75,40,35,29,11,29,64,45.3,35,34,11,23,27,102,44,1,Matches
418,Nicolás González,esESP,MF,Manchester City,23-120,2002.0,7.2,15,6,5,6,4,6,11,54.5,5,9,0,9,5,20,17,0,Matches
419,Nikola Milenković,rsSRB,DF,Nott'ham Forest,27-203,1997.0,33.0,43,26,30,11,2,21,27,77.8,6,39,23,16,24,67,178,1,Matches
420,Noni Madueke,engENG,FW,Chelsea,23-054,2002.0,19.1,22,15,7,12,3,13,33,39.4,20,14,0,14,8,30,10,0,Matches
421,Noussair Mazraoui,maMAR,DF,Manchester Utd,27-170,1997.0,29.3,102,60,53,36,13,51,85,60.0,34,33,8,25,34,136,88,1,Matches
422,Nélson Semedo,ptPOR,DF,Wolves,31-168,1993.0,29.6,58,34,31,20,7,30,53,56.6,23,28,10,18,23,81,100,3,Matches
423,Odsonne Édouard,frFRA,"MF,FW",Crystal Palace,27-107,1998.0,1.3,1,0,0,1,0,0,2,0.0,2,1,0,1,0,1,1,0,Matches
424,Odsonne Édouard,frFRA,FW,Leicester City,27-107,1998.0,0.3,1,1,1,0,0,0,0,,0,0,0,0,0,1,1,0,Matches
425,Ola Aina,ngNGA,DF,Nott'ham Forest,28-207,1996.0,29.4,54,41,39,14,1,35,62,56.5,27,32,12,20,31,85,99,3,Matches
426,Oleksandr Zinchenko,uaUKR,"DF,MF",Arsenal,28-139,1996.0,5.0,4,1,1,2,1,2,7,28.6,5,5,0,5,4,8,6,0,Matches
427,Oliver Scarles,engENG,DF,West Ham,19-142,2005.0,6.6,17,11,13,3,1,13,21,61.9,8,14,2,12,10,27,24,0,Matches
428,Oliver Skipp,engENG,MF,Leicester City,24-229,2000.0,10.1,17,4,4,10,3,8,14,57.1,6,15,3,12,9,26,10,1,Matches
429,Ollie Watkins,engENG,FW,Aston Villa,29-124,1995.0,25.1,9,6,0,5,4,3,11,27.3,8,11,3,8,7,16,14,2,Matches
430,Omar Marmoush,egEGY,"FW,MF",Manchester City,26-085,1999.0,11.1,11,6,2,7,2,7,15,46.7,8,15,1,14,5,16,3,0,Matches
431,Omari Hutchinson,engENG,"MF,FW",Ipswich Town,21-185,2003.0,24.7,30,11,14,9,7,13,45,28.9,32,24,1,23,10,40,13,1,Matches
432,Orel Mangala,beBEL,MF,Everton,27-046,1998.0,14.0,16,8,3,11,2,5,8,62.5,3,8,3,5,21,37,24,1,Matches
433,Oscar Bobb,noNOR,FW,Manchester City,21-295,2003.0,0.2,0,0,0,0,0,0,0,,0,0,0,0,0,0,0,0,Matches
434,Pablo Sarabia,esESP,"MF,FW",Wolves,32-357,1992.0,8.0,15,8,4,8,3,9,14,64.3,5,10,0,10,4,19,7,1,Matches
435,Pape Matar Sarr,snSEN,MF,Tottenham,22-231,2002.0,18.2,42,30,16,21,5,11,23,47.8,12,23,9,14,24,66,18,1,Matches
436,Patrick Dorgu,dkDEN,DF,Manchester Utd,20-189,2004.0,6.5,23,17,12,9,2,12,17,70.6,5,8,0,8,4,27,17,2,Matches
437,Patson Daka,zmZAM,"FW,MF",Leicester City,26-206,1998.0,7.2,17,9,4,9,4,7,17,41.2,10,7,1,6,1,18,8,0,Matches
438,Pau Torres,esESP,DF,Aston Villa,28-107,1997.0,19.2,20,14,11,7,2,9,15,60.0,6,14,10,4,9,29,60,2,Matches
439,Paul Onuachu,ngNGA,FW,Southampton,30-340,1994.0,10.9,7,2,1,5,1,3,7,42.9,4,6,1,5,1,8,15,1,Matches
440,Pedro Lima,brBRA,DF,Wolves,18-306,2006.0,0.8,1,0,0,0,1,1,3,33.3,2,0,0,0,2,3,5,0,Matches
441,Pedro Neto,ptPOR,FW,Chelsea,25-055,2000.0,21.4,21,9,9,8,4,7,18,38.9,11,12,2,10,8,29,5,0,Matches
442,Pedro Porro,esESP,DF,Tottenham,25-232,1999.0,27.4,63,46,31,22,10,42,73,57.5,31,44,17,27,34,97,80,1,Matches
443,Pervis Estupiñán,ecECU,DF,Brighton,27-102,1998.0,23.7,54,36,29,18,7,29,44,65.9,15,16,2,14,30,84,53,2,Matches
444,Phil Foden,engENG,"MF,FW",Manchester City,24-340,2000.0,18.8,12,5,5,4,3,7,17,41.2,10,12,1,11,9,21,7,1,Matches
445,Philip Billing,dkDEN,MF,Bournemouth,28-326,1996.0,2.0,14,5,7,6,1,3,4,75.0,1,3,0,3,5,19,2,0,Matches
446,Radu Drăgușin,roROU,DF,Tottenham,23-089,2002.0,13.9,10,6,8,2,0,6,12,50.0,6,22,16,6,15,25,49,4,Matches
447,Raheem Sterling,engENG,"FW,MF",Arsenal,30-146,1994.0,4.8,8,4,1,2,5,4,8,50.0,4,3,0,3,1,9,3,0,Matches
448,Ramón Sosa,pyPAR,"FW,MF",Nott'ham Forest,25-245,1999.0,3.0,5,3,3,0,2,1,4,25.0,3,7,0,7,3,8,4,0,Matches
449,Rasmus Højlund,dkDEN,FW,Manchester Utd,22-088,2003.0,19.4,3,1,0,2,1,0,4,0.0,4,5,0,5,1,4,6,0,Matches
450,Rayan Aït-Nouri,dzALG,DF,Wolves,23-331,2001.0,31.8,82,52,50,25,7,41,67,61.2,26,40,6,34,24,106,67,1,Matches
451,Raúl Jiménez,mxMEX,FW,Fulham,33-363,1991.0,23.7,28,18,7,14,7,6,18,33.3,12,19,5,14,9,37,19,3,Matches
452,Reece James,engENG,"DF,MF",Chelsea,25-146,1999.0,9.3,9,9,5,3,1,3,9,33.3,6,12,4,8,12,21,18,4,Matches
453,Reiss Nelson,engENG,FW,Fulham,25-144,1999.0,5.4,8,6,3,3,2,5,13,38.5,8,11,0,11,5,13,2,0,Matches
454,Reiss Nelson,engENG,FW,Arsenal,25-144,1999.0,0.0,1,0,0,1,0,0,1,0.0,1,0,0,0,0,1,1,0,Matches
455,Remy Rees-Dottin,engENG,FW,Bournemouth,19-058,2006.0,0.0,0,0,0,0,0,0,0,,0,0,0,0,0,0,0,0,Matches
456,Renato Veiga,ptPOR,"DF,MF",Chelsea,21-278,2003.0,2.0,9,6,6,3,0,4,12,33.3,8,3,1,2,1,10,2,0,Matches
457,Ricardo Pereira,ptPOR,DF,Leicester City,31-209,1993.0,3.8,11,6,4,4,3,6,12,50.0,6,6,2,4,2,13,10,0,Matches
458,Riccardo Calafiori,itITA,DF,Arsenal,22-349,2002.0,10.3,26,18,15,9,2,18,29,62.1,11,12,6,6,9,35,25,0,Matches
459,Richarlison,brBRA,FW,Tottenham,27-358,1997.0,4.5,4,3,0,3,1,0,1,0.0,1,1,1,0,0,4,8,0,Matches
460,Rico Henry,engENG,DF,Brentford,27-299,1997.0,0.7,0,0,0,0,0,0,3,0.0,3,2,1,1,1,1,0,0,Matches
461,Rico Lewis,engENG,"DF,MF",Manchester City,20-163,2004.0,20.2,29,19,13,12,4,13,21,61.9,8,28,7,21,13,42,43,1,Matches
462,Robert Sánchez,esESP,GK,Chelsea,27-166,1997.0,28.0,0,0,0,0,0,0,1,0.0,1,0,0,0,2,2,20,9,Matches
463,Robin Olsen,seSWE,GK,Aston Villa,35-115,1990.0,2.0,1,0,1,0,0,1,1,100.0,0,0,0,0,0,1,2,1,Matches
464,Rodri,esESP,MF,Manchester City,28-315,1996.0,0.7,2,1,1,1,0,0,0,,0,1,0,1,1,3,0,0,Matches
465,Rodrigo Bentancur,uyURU,MF,Tottenham,27-312,1997.0,16.9,38,20,17,17,4,19,39,48.7,20,24,8,16,36,74,33,1,Matches
466,Rodrigo Gomes,ptPOR,"DF,FW",Wolves,21-300,2003.0,7.5,21,13,12,9,0,10,19,52.6,9,8,1,7,5,26,20,1,Matches
467,Rodrigo Muniz,brBRA,FW,Fulham,23-364,2001.0,10.7,10,5,3,5,2,4,4,100.0,0,9,2,7,5,15,14,0,Matches
468,Romain Esse,engENG,MF,Crystal Palace,19-355,2005.0,0.4,2,2,2,0,0,2,2,100.0,0,1,0,1,1,3,0,0,Matches
469,Roman Dixon,engENG,DF,Everton,20-128,2004.0,1.0,5,5,3,2,0,4,4,100.0,0,1,0,1,1,6,3,0,Matches
470,Roméo Lavia,beBEL,MF,Chelsea,21-117,2004.0,6.7,19,11,5,10,4,8,16,50.0,8,6,0,6,13,32,6,0,Matches
471,Ronnie Edwards,engENG,DF,Southampton,22-036,2003.0,0.1,0,0,0,0,0,0,0,,0,1,1,0,0,0,0,0,Matches
472,Ross Barkley,engENG,MF,Aston Villa,31-149,1993.0,6.3,13,3,4,9,0,9,13,69.2,4,9,3,6,10,23,5,0,Matches
473,Ross Stewart,sctSCO,FW,Southampton,28-296,1996.0,2.7,3,2,1,0,2,2,6,33.3,4,3,0,3,0,3,6,0,Matches
474,Ryan Christie,sctSCO,MF,Bournemouth,30-070,1995.0,23.5,54,33,19,27,8,27,64,42.2,37,44,11,33,30,84,51,3,Matches
475,Ryan Fraser,sctSCO,"FW,DF",Southampton,31-068,1994.0,3.4,6,2,2,4,0,4,6,66.7,2,1,1,0,1,7,9,0,Matches
476,Ryan Gravenberch,nlNED,MF,Liverpool,22-352,2002.0,32.5,65,34,25,29,11,30,51,58.8,21,34,10,24,57,122,56,1,Matches
477,Ryan Manning,ieIRL,"DF,MF",Southampton,28-323,1996.0,15.2,28,17,16,10,2,14,26,53.8,12,19,11,8,16,44,40,0,Matches
478,Ryan Sessegnon,engENG,"FW,DF",Fulham,24-350,2000.0,4.6,19,10,7,8,4,5,13,38.5,8,9,0,9,2,21,11,0,Matches
479,Ryan Trevitt,engENG,MF,Brentford,22-052,2003.0,0.0,1,1,1,0,0,0,0,,0,0,0,0,0,1,0,0,Matches
480,Ryan Yates,engENG,MF,Nott'ham Forest,27-163,1997.0,20.7,41,21,23,14,4,17,37,45.9,20,35,9,26,26,67,59,1,Matches
481,Rúben Dias,ptPOR,DF,Manchester City,27-354,1997.0,22.2,16,10,6,9,1,7,11,63.6,4,17,14,3,18,34,59,3,Matches
482,Sam Johnstone,engENG,GK,Wolves,32-039,1993.0,7.0,0,0,0,0,0,0,1,0.0,1,0,0,0,0,0,7,0,Matches
483,Sam Morsy,egEGY,MF,Ipswich Town,33-235,1991.0,26.9,60,34,33,23,4,25,56,44.6,31,32,13,19,28,88,42,4,Matches
484,Sammie Szmodics,ieIRL,"FW,MF",Ipswich Town,29-221,1995.0,10.9,15,9,4,9,2,6,23,26.1,17,10,2,8,6,21,14,0,Matches
485,Samuel Amo-Ameyaw,engENG,"FW,DF",Southampton,18-289,2006.0,0.3,1,0,0,1,0,1,1,100.0,0,0,0,0,0,1,0,0,Matches
486,Samuel Edozie,engENG,"DF,FW",Southampton,22-095,2003.0,0.7,3,1,0,1,2,2,2,100.0,0,0,0,0,0,3,0,0,Matches
487,Sander Berge,noNOR,MF,Fulham,27-078,1998.0,22.4,48,28,22,22,4,25,37,67.6,12,26,8,18,20,68,33,1,Matches
488,Sandro Tonali,itITA,MF,Newcastle Utd,24-360,2000.0,25.2,46,29,19,22,5,21,43,48.8,22,30,10,20,30,76,32,2,Matches
489,Santiago Bueno,uyURU,DF,Wolves,26-175,1998.0,18.7,40,21,21,18,1,17,22,77.3,5,35,20,15,15,55,70,0,Matches
490,Saša Lukić,rsSRB,MF,Fulham,28-263,1996.0,23.1,62,36,17,39,6,19,49,38.8,30,17,7,10,25,87,32,0,Matches
491,Scott McTominay,sctSCO,MF,Manchester Utd,28-146,1996.0,0.2,0,0,0,0,0,0,1,0.0,1,0,0,0,0,0,1,0,Matches
492,Sean Longstaff,engENG,MF,Newcastle Utd,27-185,1997.0,8.9,27,16,10,9,8,18,27,66.7,9,17,5,12,7,34,8,0,Matches
493,Sepp van den Berg,nlNED,DF,Brentford,23-134,2001.0,24.7,35,22,22,9,4,16,25,64.0,9,48,34,14,19,54,117,2,Matches
494,Sergio Reguilón,esESP,DF,Tottenham,28-138,1996.0,1.4,4,3,1,3,0,2,3,66.7,1,4,0,4,2,6,3,0,Matches
495,Shumaira Mheuka,engENG,MF,Chelsea,17-195,2007.0,0.0,0,0,0,0,0,0,0,,0,0,0,0,0,0,0,0,Matches
496,Simon Adingra,ciCIV,"FW,MF",Brighton,23-122,2002.0,9.9,21,13,9,8,4,9,21,42.9,12,11,0,11,8,29,5,1,Matches
497,Solly March,engENG,"FW,MF",Brighton,30-287,1994.0,1.9,6,3,2,2,2,5,8,62.5,3,3,0,3,2,8,2,1,Matches
498,Son Heung-min,krKOR,FW,Tottenham,32-299,1992.0,22.3,17,9,3,8,6,5,23,21.7,18,10,0,10,5,22,16,1,Matches
499,Stefan Ortega,deGER,GK,Manchester City,32-178,1992.0,12.2,0,0,0,0,0,0,1,0.0,1,0,0,0,0,0,11,1,Matches
500,Stephy Mavididi,engENG,FW,Leicester City,26-337,1998.0,17.9,34,19,16,10,8,14,42,33.3,28,26,2,24,11,45,15,0,Matches
501,Sven Botman,nlNED,DF,Newcastle Utd,25-111,2000.0,2.6,6,4,3,3,0,2,3,66.7,1,2,1,1,4,10,13,0,Matches
502,Sávio,brBRA,"FW,MF",Manchester City,21-023,2004.0,19.3,22,16,5,10,7,9,18,50.0,9,13,2,11,6,28,9,1,Matches
503,Séamus Coleman,ieIRL,DF,Everton,36-204,1988.0,2.2,2,1,1,1,0,2,3,66.7,1,5,3,2,1,3,7,0,Matches
504,Taiwo Awoniyi,ngNGA,FW,Nott'ham Forest,27-264,1997.0,4.5,6,3,0,3,3,4,5,80.0,1,1,0,1,0,6,7,0,Matches
505,Takehiro Tomiyasu,jpJPN,DF,Arsenal,26-179,1998.0,0.1,0,0,0,0,0,0,0,,0,0,0,0,0,0,1,0,Matches
506,Tariq Lamptey,ghGHA,DF,Brighton,24-215,2000.0,8.5,14,10,8,6,0,7,22,31.8,15,12,5,7,6,20,21,1,Matches
507,Taylor Harwood-Bellis,engENG,DF,Southampton,23-093,2002.0,28.5,27,19,13,11,3,19,33,57.6,14,59,37,22,30,57,130,6,Matches
508,Thiago,brBRA,FW,Brentford,23-311,2001.0,1.5,2,2,1,0,1,0,1,0.0,1,0,0,0,2,4,2,1,Matches
509,Thomas Partey,ghGHA,"MF,DF",Arsenal,31-324,1993.0,27.1,79,48,23,36,20,43,68,63.2,25,23,7,16,32,111,46,4,Matches
510,Tim Iroegbunam,engENG,MF,Everton,21-307,2003.0,6.3,27,13,12,10,5,14,22,63.6,8,16,4,12,15,42,11,1,Matches
511,Timo Werner,deGER,"FW,MF",Tottenham,29-058,1996.0,5.7,6,4,3,3,0,3,13,23.1,10,10,1,9,1,7,7,0,Matches
512,Timothy Castagne,beBEL,DF,Fulham,29-149,1995.0,18.1,46,29,28,15,3,26,45,57.8,19,15,6,9,22,68,82,0,Matches
513,Toby Collyer,engENG,MF,Manchester Utd,21-120,2004.0,2.0,12,9,6,6,0,5,6,83.3,1,2,1,1,2,14,3,0,Matches
514,Tom Cairney,sctSCO,MF,Fulham,34-103,1991.0,5.5,11,5,4,2,5,4,7,57.1,3,5,1,4,4,15,1,1,Matches
515,Tommy Doyle,engENG,MF,Wolves,23-198,2001.0,5.4,11,6,6,3,2,6,15,40.0,9,11,5,6,5,16,11,1,Matches
516,Tomáš Souček,czCZE,MF,West Ham,30-065,1995.0,25.0,40,19,19,18,3,20,37,54.1,17,34,17,17,18,58,74,1,Matches
517,Tosin Adarabioyo,engENG,DF,Chelsea,27-221,1997.0,13.7,14,10,10,4,0,8,12,66.7,4,9,7,2,10,24,62,0,Matches
518,Toti Gomes,ptPOR,DF,Wolves,26-107,1999.0,26.0,53,38,37,14,2,30,37,81.1,7,28,17,11,23,76,134,5,Matches
519,Trent Alexander-Arnold,engENG,DF,Liverpool,26-208,1998.0,24.9,70,49,43,18,9,48,101,47.5,53,25,8,17,30,100,54,4,Matches
520,Trevoh Chalobah,engENG,DF,Chelsea,25-302,1999.0,8.3,7,4,3,4,0,5,6,83.3,1,4,2,2,7,14,39,1,Matches
521,Trevoh Chalobah,engENG,DF,Crystal Palace,25-302,1999.0,11.8,20,16,7,12,1,12,23,52.2,11,19,9,10,19,39,57,3,Matches
522,Tyler Adams,usUSA,MF,Bournemouth,26-078,1999.0,18.0,75,46,24,44,7,35,63,55.6,28,33,10,23,31,106,38,0,Matches
523,Tyler Dibling,engENG,"FW,MF",Southampton,19-052,2006.0,18.9,34,20,13,18,3,16,26,61.5,10,19,5,14,8,42,14,1,Matches
524,Tyler Fredricson,engENG,DF,Manchester Utd,20-069,2005.0,1.0,4,2,2,2,0,0,1,0.0,1,0,0,0,1,5,4,0,Matches
525,Tyrell Malacia,nlNED,DF,Manchester Utd,25-259,1999.0,1.1,2,1,2,0,0,1,2,50.0,1,0,0,0,1,3,1,1,Matches
526,Tyrick Mitchell,engENG,DF,Crystal Palace,25-244,1999.0,31.7,85,52,53,25,7,21,41,51.2,20,62,12,50,14,99,97,2,Matches
527,Tyrique George,engENG,FW,Chelsea,19-088,2006.0,1.1,2,0,2,0,0,2,3,66.7,1,0,0,0,1,3,1,0,Matches
528,Tyrone Mings,engENG,DF,Aston Villa,32-051,1993.0,11.7,6,5,5,1,0,2,2,100.0,0,13,11,2,7,13,58,1,Matches
529,Valentino Livramento,engENG,DF,Newcastle Utd,22-172,2002.0,27.6,50,33,32,14,4,29,54,53.7,25,33,10,23,21,71,95,1,Matches
530,Victor Bernth Kristiansen,dkDEN,DF,Leicester City,22-138,2002.0,26.4,85,50,54,26,5,47,87,54.0,40,37,14,23,40,125,72,3,Matches
531,Victor Lindelöf,seSWE,DF,Manchester Utd,30-290,1994.0,5.2,5,1,5,0,0,2,3,66.7,1,4,2,2,7,12,32,1,Matches
532,Virgil van Dijk,nlNED,DF,Liverpool,33-299,1991.0,34.0,35,17,17,16,2,11,20,55.0,9,24,13,11,52,87,175,4,Matches
533,Vitaliy Mykolenko,uaUKR,DF,Everton,25-339,1999.0,30.2,54,32,32,14,8,25,50,50.0,25,24,9,15,36,90,131,1,Matches
534,Vitaly Janelt,deGER,MF,Brentford,26-358,1998.0,25.0,38,22,14,13,11,21,36,58.3,15,33,9,24,27,65,53,1,Matches
535,Vitezslav Jaros,czCZE,GK,Liverpool,23-284,2001.0,0.1,0,0,0,0,0,0,0,,0,0,0,0,0,0,0,0,Matches
536,Vitor Reis,brBRA,DF,Manchester City,19-111,2006.0,0.0,0,0,0,0,0,0,0,,0,0,0,0,0,0,1,0,Matches
537,Vladimír Coufal,czCZE,DF,West Ham,32-254,1992.0,9.6,17,11,10,5,2,7,18,38.9,11,13,11,2,8,25,37,1,Matches
538,Wataru Endo,jpJPN,MF,Liverpool,32-083,1993.0,1.9,8,6,4,4,0,5,8,62.5,3,5,0,5,3,11,7,0,Matches
539,Welington,brBRA,"DF,MF",Southampton,24-073,2001.0,2.4,13,5,9,3,1,7,12,58.3,5,3,1,2,3,16,12,0,Matches
540,Wes Burns,wlsWAL,"FW,DF",Ipswich Town,30-161,1994.0,10.3,13,11,1,9,3,4,10,40.0,6,7,2,5,10,23,13,2,Matches
541,Wesley Fofana,frFRA,DF,Chelsea,24-137,2000.0,13.0,13,12,6,7,0,6,14,42.9,8,14,9,5,14,27,55,2,Matches
542,Wilfred Ndidi,ngNGA,MF,Leicester City,28-138,1996.0,22.9,77,46,43,29,5,25,51,49.0,26,45,19,26,24,101,70,0,Matches
543,Will Alves,engENG,FW,Leicester City,20-089,2005.0,0.0,0,0,0,0,0,0,0,,0,0,0,0,0,0,0,0,Matches
544,Will Hughes,engENG,MF,Crystal Palace,30-016,1995.0,20.8,61,33,17,31,13,27,59,45.8,32,29,14,15,19,80,23,3,Matches
545,Will Lankshear,engENG,"FW,MF",Tottenham,20-013,2005.0,0.1,0,0,0,0,0,0,0,,0,0,0,0,0,0,0,0,Matches
546,William Osula,dkDEN,FW,Newcastle Utd,21-272,2003.0,1.2,1,0,0,0,1,0,2,0.0,2,0,0,0,4,5,2,0,Matches
547,William Saliba,frFRA,DF,Arsenal,24-040,2001.0,31.3,58,34,33,23,2,20,26,76.9,6,23,14,9,21,79,107,6,Matches
548,William Smallbone,ieIRL,MF,Southampton,25-071,2000.0,6.8,17,10,8,7,2,6,18,33.3,12,7,0,7,2,19,12,2,Matches
549,Willian,brBRA,"FW,MF",Fulham,36-267,1988.0,2.5,3,1,0,2,1,1,5,20.0,4,0,0,0,1,4,1,0,Matches
550,Willy Boly,ciCIV,DF,Nott'ham Forest,34-089,1991.0,1.7,6,1,5,1,0,4,4,100.0,0,4,2,2,3,9,12,0,Matches
551,Wilson Odobert,frFRA,FW,Tottenham,20-156,2004.0,6.0,8,2,3,3,2,5,10,50.0,5,4,0,4,3,11,2,1,Matches
552,Wout Faes,beBEL,DF,Leicester City,27-030,1998.0,27.3,38,23,25,11,2,22,42,52.4,20,45,33,12,26,64,158,4,Matches
553,Woyo Coulibaly,frFRA,DF,Leicester City,25-348,1999.0,1.2,6,4,4,2,0,2,2,100.0,0,3,1,2,5,11,1,0,Matches
554,Yankuba Minteh,gmGAM,"FW,MF",Brighton,20-285,2004.0,16.6,43,31,23,12,8,17,45,37.8,28,17,0,17,10,53,28,0,Matches
555,Yasin Ayari,seSWE,MF,Brighton,21-209,2003.0,19.3,53,29,15,28,10,20,50,40.0,30,22,6,16,20,73,23,0,Matches
556,Yehor Yarmoliuk,uaUKR,MF,Brentford,21-063,2004.0,12.5,37,23,14,17,6,23,46,50.0,23,23,6,17,10,47,31,0,Matches
557,Yerson Mosquera,coCOL,DF,Wolves,24-001,2001.0,4.9,11,7,9,2,0,9,14,64.3,5,13,10,3,10,21,14,0,Matches
558,Yoane Wissa,cdCOD,FW,Brentford,28-242,1996.0,28.4,21,11,6,7,8,10,25,40.0,15,28,7,21,8,29,20,3,Matches
559,Youri Tielemans,beBEL,MF,Aston Villa,27-361,1997.0,32.4,82,56,30,44,8,39,72,54.2,33,36,15,21,21,103,45,3,Matches
560,Youssef Chermiti,ptPOR,"FW,MF",Everton,20-344,2004.0,0.5,0,0,0,0,0,0,0,,0,0,0,0,0,0,0,0,Matches
561,Yukinari Sugawara,jpJPN,"DF,MF",Southampton,24-309,2000.0,16.3,29,16,14,14,1,18,30,60.0,12,17,7,10,10,39,46,3,Matches
562,Yunus Emre Konak,trTUR,"FW,MF",Brentford,19-113,2006.0,0.5,4,4,0,4,0,1,2,50.0,1,2,0,2,0,4,0,0,Matches
563,Yves Bissouma,mlMLI,MF,Tottenham,28-246,1996.0,13.4,44,28,17,24,3,17,32,53.1,15,7,4,3,14,58,32,4,Matches
564,Zain Silcott-Duberry,msMSR,FW,Bournemouth,19-298,2005.0,0.0,1,1,0,0,1,1,1,100.0,0,0,0,0,0,1,0,0,Matches
565,Álex Moreno,esESP,"DF,MF",Nott'ham Forest,31-329,1993.0,10.6,25,18,20,5,0,15,39,38.5,24,11,5,6,15,40,43,0,Matches
566,İlkay Gündoğan,deGER,MF,Manchester City,34-191,1990.0,22.8,24,13,4,15,5,10,23,43.5,13,14,0,14,13,37,22,0,Matches
567,Łukasz Fabiański,plPOL,GK,West Ham,40-015,1985.0,11.9,0,0,0,0,0,0,1,0.0,1,0,0,0,0,0,5,1,Matches
